Flight_ID,Airline,Origin_Airport,Destination_Airport,Scheduled_Departure,Weather_Delay,Air_Traffic_Delay,Security_Delay,Aircraft_Maintenance_Delay,Total_Delay
1,Delta,ORD,BOS,7,35,7,3,17,62
2,American,ORD,BOS,3,37,8,1,20,66
3,JetBlue,ORD,MIA,1,44,49,10,28,131
4,United,DFW,DEN,22,25,53,12,0,90
5,Southwest,JFK,DEN,5,39,14,11,8,72
6,American,DFW,PHX,6,18,8,2,14,42
7,JetBlue,LAX,BOS,7,57,3,11,14,85
8,United,JFK,PHX,3,12,35,8,13,68
9,Southwest,ORD,SEA,20,26,20,1,21,68
10,Delta,ORD,DEN,21,49,45,12,20,126
11,Delta,ATL,BOS,7,19,16,14,19,68
12,United,DFW,DEN,22,34,43,4,10,91
13,American,JFK,MIA,7,34,28,3,2,67
14,Delta,JFK,PHX,22,43,33,14,27,117
15,Southwest,ORD,PHX,13,32,27,2,18,79
16,American,DFW,DEN,2,38,40,6,29,113
17,United,JFK,DEN,19,49,0,8,10,67
18,Southwest,JFK,DEN,15,29,44,3,25,101
19,JetBlue,LAX,MIA,6,18,56,0,14,88
20,JetBlue,DFW,DEN,1,36,40,7,14,97
21,Delta,ATL,PHX,10,31,21,13,15,80
22,JetBlue,LAX,SEA,1,28,14,13,10,65
23,United,ATL,MIA,20,25,36,10,18,89
24,United,JFK,DEN,22,21,22,13,2,58
25,Southwest,ATL,PHX,5,16,0,10,13,39
26,Delta,DFW,MIA,21,58,52,3,19,132
27,Southwest,LAX,DEN,2,28,7,10,18,63
28,American,JFK,MIA,5,9,42,12,10,73
29,Delta,ATL,DEN,11,2,34,1,0,37
30,United,DFW,DEN,15,14,14,0,18,46
31,JetBlue,DFW,DEN,6,45,0,2,6,53
32,JetBlue,LAX,MIA,7,17,42,6,21,86
33,Delta,DFW,BOS,21,26,36,4,3,69
34,Southwest,ORD,MIA,8,41,20,4,8,73
35,Delta,ORD,BOS,7,15,32,0,18,65
36,Delta,ORD,MIA,23,4,45,0,28,77
37,Southwest,DFW,SEA,16,10,15,1,4,30
38,American,ORD,BOS,5,50,54,0,27,131
39,Delta,ORD,MIA,21,50,30,8,15,103
40,Delta,ATL,DEN,6,14,30,12,5,61
41,Southwest,LAX,MIA,7,13,55,5,24,97
42,JetBlue,ORD,BOS,17,16,24,2,14,56
43,JetBlue,LAX,DEN,15,4,10,13,21,48
44,United,ORD,DEN,20,17,50,8,20,95
45,American,DFW,DEN,16,27,2,6,27,62
46,JetBlue,JFK,MIA,9,52,54,5,5,116
47,Southwest,DFW,BOS,15,34,30,0,23,87
48,American,DFW,DEN,3,16,19,3,19,57
49,Southwest,JFK,MIA,21,19,45,5,3,72
50,JetBlue,ORD,PHX,2,34,23,12,2,71
51,American,ORD,BOS,5,41,10,10,20,81
52,American,ATL,MIA,13,50,49,1,25,125
53,JetBlue,ORD,PHX,20,20,45,0,26,91
54,Delta,ATL,DEN,22,10,20,10,12,52
55,American,JFK,SEA,6,32,14,8,17,71
56,JetBlue,LAX,DEN,3,2,15,6,23,46
57,American,LAX,DEN,18,19,51,8,21,99
58,American,ORD,PHX,21,22,23,8,0,53
59,Southwest,ORD,SEA,23,36,6,13,1,56
60,Southwest,DFW,DEN,10,34,58,7,22,121
61,United,ATL,MIA,15,3,8,7,10,28
62,Delta,DFW,MIA,0,52,8,1,17,78
63,Delta,ORD,BOS,17,57,52,3,23,135
64,Southwest,LAX,SEA,23,31,7,8,2,48
65,Delta,ORD,BOS,9,21,55,1,16,93
66,Southwest,ATL,SEA,5,5,23,14,23,65
67,United,ATL,BOS,17,13,57,13,14,97
68,Delta,JFK,DEN,2,3,19,5,7,34
69,United,LAX,SEA,23,38,53,0,22,113
70,American,LAX,BOS,10,52,36,9,3,100
71,Delta,JFK,MIA,8,7,35,3,20,65
72,American,ORD,BOS,5,4,57,3,15,79
73,Delta,LAX,BOS,18,18,4,6,12,40
74,American,DFW,PHX,11,14,52,13,17,96
75,Delta,LAX,BOS,5,43,29,3,2,77
76,American,JFK,SEA,15,10,26,13,8,57
77,United,ATL,SEA,7,59,19,13,13,104
78,JetBlue,LAX,SEA,7,29,24,9,18,80
79,Delta,DFW,SEA,4,32,6,0,7,45
80,Delta,JFK,DEN,1,47,10,4,6,67
81,Southwest,ATL,MIA,2,29,32,7,11,79
82,United,ORD,SEA,7,13,33,5,12,63
83,Southwest,ORD,SEA,19,56,8,4,27,95
84,Southwest,ATL,DEN,11,39,25,10,1,75
85,Southwest,DFW,BOS,4,59,33,14,26,132
86,United,DFW,MIA,6,15,27,9,25,76
87,American,ATL,PHX,21,12,52,14,27,105
88,United,JFK,BOS,7,29,22,3,19,73
89,United,ATL,MIA,0,34,9,5,27,75
90,Southwest,JFK,BOS,3,23,45,12,24,104
91,Delta,LAX,MIA,22,12,59,6,6,83
92,United,ORD,SEA,12,35,32,6,29,102
93,United,ORD,PHX,7,25,10,14,7,56
94,JetBlue,DFW,PHX,15,15,51,12,10,88
95,American,JFK,DEN,6,25,4,13,17,59
96,JetBlue,LAX,SEA,20,19,17,2,13,51
97,United,LAX,DEN,12,45,2,6,11,64
98,JetBlue,LAX,PHX,0,42,44,2,25,113
99,Southwest,DFW,SEA,2,48,24,1,9,82
100,Southwest,ORD,DEN,18,32,4,10,28,74
101,Delta,LAX,BOS,12,1,40,12,10,63
102,Delta,LAX,MIA,20,36,14,5,1,56
103,Southwest,DFW,DEN,5,26,34,10,23,93
104,United,DFW,MIA,13,26,7,9,27,69
105,United,ORD,MIA,3,45,33,2,20,100
106,JetBlue,LAX,BOS,4,27,2,11,6,46
107,Southwest,JFK,BOS,22,41,38,0,1,80
108,JetBlue,ORD,DEN,6,21,30,11,28,90
109,JetBlue,ORD,PHX,0,5,14,0,13,32
110,Southwest,JFK,DEN,20,59,40,7,27,133
111,JetBlue,ATL,PHX,22,56,4,7,8,75
112,American,ATL,DEN,9,49,1,10,25,85
113,United,DFW,PHX,17,28,15,9,29,81
114,Delta,JFK,BOS,10,52,14,12,1,79
115,JetBlue,DFW,BOS,1,41,5,12,10,68
116,United,JFK,BOS,17,4,31,13,18,66
117,United,LAX,DEN,13,12,36,9,28,85
118,Delta,ORD,DEN,16,54,10,1,13,78
119,Delta,LAX,SEA,0,46,39,7,21,113
120,American,LAX,SEA,17,39,56,5,19,119
121,United,JFK,DEN,22,40,35,5,27,107
122,American,LAX,SEA,12,55,10,4,27,96
123,JetBlue,LAX,DEN,15,22,20,1,29,72
124,Southwest,DFW,MIA,19,25,47,11,14,97
125,United,ATL,DEN,8,42,17,9,22,90
126,Delta,ATL,PHX,3,50,26,7,13,96
127,United,DFW,BOS,16,14,18,3,1,36
128,Southwest,LAX,DEN,17,20,6,11,16,53
129,JetBlue,LAX,SEA,13,47,41,3,22,113
130,JetBlue,LAX,BOS,10,28,54,0,14,96
131,Delta,DFW,PHX,20,5,52,14,9,80
132,Delta,DFW,SEA,9,51,19,0,12,82
133,United,DFW,PHX,19,58,48,5,4,115
134,United,JFK,SEA,5,23,15,2,6,46
135,Southwest,ATL,SEA,22,45,44,11,6,106
136,American,JFK,DEN,22,31,4,6,25,66
137,American,ORD,BOS,10,3,22,4,24,53
138,United,JFK,MIA,17,4,23,4,11,42
139,Delta,ORD,SEA,2,2,28,2,4,36
140,Southwest,DFW,BOS,17,58,17,7,26,108
141,Southwest,DFW,DEN,2,22,27,12,29,90
142,Delta,LAX,BOS,8,3,4,9,21,37
143,United,ATL,BOS,15,38,56,2,6,102
144,Delta,ATL,BOS,22,12,24,0,10,46
145,United,ORD,SEA,21,27,5,4,12,48
146,Delta,ATL,PHX,6,8,33,5,10,56
147,Delta,ORD,PHX,23,2,1,10,8,21
148,Delta,LAX,MIA,8,32,31,1,10,74
149,Delta,LAX,PHX,13,45,10,11,27,93
150,Delta,ORD,BOS,12,26,28,13,23,90
151,United,LAX,BOS,0,2,31,2,6,41
152,United,JFK,DEN,7,52,48,8,13,121
153,American,JFK,MIA,8,34,34,11,26,105
154,American,LAX,DEN,0,15,20,12,25,72
155,Southwest,ORD,SEA,12,16,50,7,15,88
156,Southwest,ORD,SEA,23,5,1,7,21,34
157,JetBlue,ORD,PHX,19,33,17,14,8,72
158,JetBlue,LAX,DEN,2,39,4,6,11,60
159,Southwest,JFK,BOS,5,49,11,4,17,81
160,Delta,DFW,MIA,23,12,52,3,19,86
161,United,ORD,PHX,18,24,57,10,24,115
162,Southwest,JFK,DEN,19,21,14,13,6,54
163,American,DFW,MIA,1,41,46,5,24,116
164,United,JFK,BOS,18,31,18,8,17,74
165,United,DFW,BOS,1,17,18,10,17,62
166,American,ATL,SEA,19,5,58,10,23,96
167,Southwest,DFW,SEA,3,36,55,7,16,114
168,Southwest,DFW,PHX,5,31,34,1,23,89
169,Delta,ORD,MIA,11,54,44,11,18,127
170,Southwest,ATL,MIA,10,24,21,2,9,56
171,United,LAX,PHX,4,51,20,6,14,91
172,United,ORD,MIA,4,15,17,12,4,48
173,United,ATL,BOS,3,33,11,5,13,62
174,American,LAX,DEN,4,31,4,12,15,62
175,Southwest,ATL,SEA,21,13,51,13,19,96
176,Delta,ATL,PHX,2,44,58,1,28,131
177,Southwest,JFK,MIA,19,45,52,9,8,114
178,Delta,ORD,PHX,4,41,26,8,4,79
179,JetBlue,ORD,PHX,7,25,49,0,16,90
180,Southwest,DFW,BOS,6,28,14,5,18,65
181,Delta,JFK,PHX,1,34,30,0,29,93
182,American,ATL,SEA,11,17,33,0,19,69
183,United,DFW,MIA,17,13,17,1,6,37
184,Delta,ORD,SEA,9,55,21,11,10,97
185,United,DFW,SEA,21,38,42,12,2,94
186,United,ORD,DEN,17,1,9,0,4,14
187,JetBlue,LAX,MIA,12,49,22,4,12,87
188,JetBlue,DFW,MIA,22,31,1,5,29,66
189,Delta,DFW,PHX,8,30,39,11,5,85
190,Southwest,LAX,DEN,5,50,48,4,3,105
191,JetBlue,DFW,SEA,7,54,27,4,4,89
192,JetBlue,DFW,PHX,15,35,57,14,9,115
193,American,ATL,MIA,12,47,5,0,29,81
194,Delta,ATL,DEN,20,15,7,6,28,56
195,Southwest,JFK,DEN,6,31,7,2,12,52
196,Southwest,ATL,DEN,16,59,5,1,17,82
197,United,JFK,PHX,18,29,12,2,24,67
198,American,ORD,DEN,16,23,24,9,25,81
199,American,LAX,PHX,1,16,4,4,14,38
200,Southwest,DFW,SEA,12,28,40,4,28,100
201,United,JFK,MIA,4,9,25,11,20,65
202,United,ATL,SEA,23,31,7,6,11,55
203,American,ORD,SEA,20,2,14,7,9,32
204,JetBlue,ATL,SEA,6,50,39,12,5,106
205,American,ATL,MIA,10,25,24,6,23,78
206,Southwest,JFK,PHX,5,53,49,6,21,129
207,United,ORD,SEA,8,44,20,13,4,81
208,Delta,LAX,DEN,22,44,43,3,15,105
209,American,ATL,SEA,18,37,19,9,11,76
210,United,ORD,SEA,20,11,15,5,12,43
211,United,DFW,BOS,7,31,58,6,15,110
212,JetBlue,JFK,DEN,20,58,3,10,22,93
213,United,ATL,PHX,11,0,50,1,20,71
214,Delta,JFK,SEA,23,7,30,8,4,49
215,Southwest,ATL,PHX,1,51,1,5,23,80
216,United,ATL,MIA,15,29,13,0,25,67
217,Southwest,JFK,MIA,22,57,33,14,3,107
218,JetBlue,LAX,MIA,0,55,24,1,14,94
219,American,LAX,DEN,16,43,28,6,15,92
220,American,LAX,BOS,3,0,23,9,21,53
221,Southwest,DFW,BOS,6,44,13,0,10,67
222,Southwest,ATL,SEA,23,6,44,6,28,84
223,Southwest,DFW,SEA,8,5,59,6,3,73
224,JetBlue,ORD,DEN,9,23,49,11,16,99
225,American,ATL,SEA,11,38,6,1,17,62
226,Delta,LAX,SEA,17,30,16,2,5,53
227,JetBlue,ATL,DEN,16,38,23,0,27,88
228,JetBlue,JFK,MIA,11,59,30,4,10,103
229,Delta,LAX,BOS,20,15,7,14,9,45
230,American,ORD,DEN,17,17,57,10,15,99
231,JetBlue,ORD,BOS,19,24,12,9,21,66
232,Delta,LAX,MIA,13,15,55,11,29,110
233,JetBlue,ATL,BOS,17,39,42,2,14,97
234,JetBlue,DFW,PHX,13,21,4,6,14,45
235,United,LAX,MIA,18,51,43,13,3,110
236,American,JFK,PHX,23,20,20,7,9,56
237,Southwest,LAX,SEA,7,8,12,4,18,42
238,American,JFK,DEN,12,47,52,5,11,115
239,Southwest,ORD,SEA,0,15,10,4,12,41
240,Delta,DFW,BOS,18,13,31,6,14,64
241,United,ATL,DEN,6,18,3,12,2,35
242,American,JFK,SEA,12,53,2,6,25,86
243,United,JFK,SEA,12,56,50,4,5,115
244,Southwest,LAX,DEN,15,9,47,4,11,71
245,United,JFK,MIA,15,0,1,4,14,19
246,Delta,ORD,MIA,1,57,9,2,23,91
247,United,LAX,SEA,11,40,23,9,22,94
248,United,ORD,SEA,18,47,34,9,14,104
249,Southwest,DFW,BOS,1,2,32,5,10,49
250,American,ATL,MIA,13,35,8,7,11,61
251,American,ATL,PHX,2,40,9,2,24,75
252,Southwest,ATL,DEN,7,45,5,0,16,66
253,American,ORD,MIA,5,14,25,0,26,65
254,Southwest,ATL,DEN,21,24,19,0,29,72
255,JetBlue,DFW,BOS,4,2,20,12,21,55
256,JetBlue,LAX,MIA,3,46,42,5,8,101
257,JetBlue,JFK,SEA,13,41,19,14,23,97
258,Southwest,DFW,MIA,11,53,56,12,20,141
259,JetBlue,ATL,MIA,5,40,29,0,3,72
260,American,LAX,PHX,17,59,38,5,12,114
261,JetBlue,JFK,DEN,6,10,3,2,26,41
262,Delta,DFW,DEN,19,0,8,12,13,33
263,United,DFW,SEA,21,28,23,3,28,82
264,American,LAX,MIA,20,10,20,12,5,47
265,JetBlue,ATL,SEA,6,2,7,6,29,44
266,United,ATL,SEA,5,24,47,0,25,96
267,American,DFW,MIA,9,55,18,3,2,78
268,JetBlue,ATL,SEA,8,54,33,4,27,118
269,JetBlue,ATL,BOS,1,3,56,5,13,77
270,JetBlue,DFW,PHX,4,58,45,13,25,141
271,JetBlue,ORD,SEA,22,41,3,12,11,67
272,Southwest,ATL,SEA,18,36,49,14,12,111
273,JetBlue,LAX,MIA,3,28,32,13,29,102
274,American,ORD,BOS,21,27,24,12,11,74
275,Southwest,ATL,SEA,7,20,24,3,2,49
276,American,JFK,PHX,22,33,8,8,4,53
277,JetBlue,ORD,SEA,18,45,38,12,10,105
278,United,LAX,SEA,14,19,53,2,28,102
279,JetBlue,ORD,PHX,8,17,24,4,29,74
280,American,ORD,BOS,18,55,27,0,1,83
281,Southwest,JFK,SEA,14,18,41,0,4,63
282,American,DFW,BOS,2,26,38,2,5,71
283,American,JFK,MIA,8,34,6,3,13,56
284,Southwest,ATL,BOS,11,58,4,8,4,74
285,American,ATL,DEN,3,26,37,13,14,90
286,JetBlue,JFK,PHX,1,15,8,1,14,38
287,Southwest,ATL,BOS,19,36,45,4,11,96
288,United,ORD,SEA,23,10,5,5,28,48
289,Delta,ORD,PHX,0,7,23,14,20,64
290,American,JFK,DEN,16,12,58,13,28,111
291,American,ORD,MIA,8,56,28,3,14,101
292,American,DFW,PHX,5,2,53,11,10,76
293,JetBlue,LAX,PHX,14,22,49,11,21,103
294,Delta,DFW,DEN,13,26,3,3,16,48
295,American,DFW,SEA,4,23,59,8,11,101
296,United,ATL,PHX,7,28,27,6,4,65
297,JetBlue,JFK,BOS,22,26,47,3,21,97
298,Delta,JFK,DEN,3,39,46,2,24,111
299,Delta,ORD,MIA,18,55,31,9,14,109
300,American,DFW,SEA,0,9,45,8,1,63
301,JetBlue,ATL,DEN,11,58,58,11,6,133
302,JetBlue,JFK,MIA,0,46,11,7,16,80
303,American,LAX,SEA,21,48,29,2,20,99
304,United,JFK,SEA,10,44,32,11,0,87
305,JetBlue,DFW,BOS,0,47,12,1,23,83
306,Delta,ORD,DEN,12,52,26,12,15,105
307,JetBlue,JFK,MIA,6,40,39,12,10,101
308,JetBlue,JFK,DEN,0,1,47,10,13,71
309,United,DFW,BOS,15,56,13,8,22,99
310,JetBlue,ORD,BOS,6,59,40,2,24,125
311,Southwest,LAX,SEA,6,7,18,4,13,42
312,United,JFK,BOS,11,38,33,4,6,81
313,Delta,JFK,MIA,13,6,30,5,22,63
314,Southwest,LAX,SEA,14,23,11,11,5,50
315,American,ORD,DEN,15,5,43,1,9,58
316,JetBlue,LAX,MIA,20,59,20,7,24,110
317,JetBlue,DFW,SEA,18,44,48,13,5,110
318,American,LAX,MIA,7,41,43,12,14,110
319,American,ATL,MIA,19,9,14,2,4,29
320,Southwest,DFW,BOS,5,52,36,1,5,94
321,JetBlue,LAX,SEA,8,30,21,4,8,63
322,JetBlue,ORD,SEA,3,15,26,0,2,43
323,Southwest,ORD,SEA,12,45,23,4,27,99
324,American,LAX,BOS,5,41,49,11,11,112
325,American,ATL,DEN,14,0,7,2,21,30
326,Delta,ORD,PHX,15,33,10,11,1,55
327,Southwest,ATL,BOS,19,5,58,2,23,88
328,American,ORD,PHX,9,40,17,2,27,86
329,Delta,JFK,PHX,6,29,10,12,14,65
330,JetBlue,LAX,SEA,16,53,34,12,14,113
331,American,JFK,MIA,21,37,56,0,11,104
332,American,JFK,PHX,1,11,15,8,6,40
333,American,ORD,PHX,14,33,9,9,7,58
334,JetBlue,ATL,BOS,11,49,13,7,24,93
335,American,LAX,MIA,21,2,46,8,0,56
336,American,ORD,SEA,5,20,7,6,16,49
337,Southwest,JFK,DEN,4,30,3,0,10,43
338,Southwest,ATL,DEN,20,48,0,1,24,73
339,Southwest,ATL,BOS,4,13,27,1,7,48
340,American,LAX,MIA,17,19,41,14,7,81
341,Delta,DFW,DEN,7,12,19,1,22,54
342,Southwest,LAX,MIA,20,29,45,0,0,74
343,Southwest,JFK,MIA,3,29,48,13,23,113
344,American,JFK,DEN,7,34,42,14,8,98
345,Southwest,LAX,DEN,12,19,4,14,23,60
346,JetBlue,ORD,BOS,6,35,23,12,4,74
347,Southwest,ATL,DEN,9,8,13,3,3,27
348,United,ATL,SEA,4,58,32,6,29,125
349,JetBlue,ATL,DEN,12,35,39,8,3,85
350,American,JFK,BOS,13,12,6,13,16,47
351,Southwest,ATL,SEA,20,50,24,9,12,95
352,Delta,ATL,BOS,3,30,32,12,6,80
353,Delta,ATL,PHX,7,51,9,11,15,86
354,JetBlue,DFW,BOS,6,1,54,8,19,82
355,United,ORD,SEA,10,42,22,3,8,75
356,JetBlue,ATL,SEA,13,57,53,8,9,127
357,United,LAX,MIA,4,48,54,5,2,109
358,JetBlue,ATL,DEN,19,15,22,10,24,71
359,United,LAX,BOS,1,20,44,5,22,91
360,Southwest,JFK,DEN,23,17,36,1,24,78
361,American,ATL,MIA,9,7,15,8,7,37
362,Southwest,ATL,PHX,9,36,0,12,29,77
363,American,ATL,PHX,20,54,56,2,5,117
364,Delta,ORD,PHX,7,53,25,8,5,91
365,JetBlue,DFW,MIA,4,55,50,10,20,135
366,JetBlue,ORD,BOS,2,37,12,10,0,59
367,Delta,ORD,MIA,10,37,51,13,10,111
368,American,DFW,MIA,20,1,12,11,14,38
369,JetBlue,LAX,PHX,10,28,1,2,2,33
370,United,DFW,PHX,21,27,28,9,28,92
371,JetBlue,DFW,MIA,0,35,9,4,29,77
372,Southwest,ORD,SEA,2,27,58,9,4,98
373,American,JFK,SEA,16,51,36,8,28,123
374,Delta,DFW,PHX,1,35,39,1,8,83
375,JetBlue,LAX,BOS,5,58,42,2,17,119
376,Delta,DFW,PHX,4,29,32,2,10,73
377,United,ATL,PHX,7,5,20,4,16,45
378,JetBlue,JFK,DEN,0,11,26,10,11,58
379,JetBlue,DFW,SEA,16,26,23,2,0,51
380,American,JFK,MIA,23,44,59,3,23,129
381,American,ORD,BOS,0,16,41,5,17,79
382,Delta,ORD,MIA,14,4,56,7,5,72
383,Delta,DFW,PHX,5,14,50,6,21,91
384,Southwest,ATL,BOS,15,0,24,0,14,38
385,American,LAX,SEA,22,47,15,13,2,77
386,Southwest,DFW,PHX,21,10,8,11,24,53
387,Delta,LAX,BOS,22,55,30,14,28,127
388,American,LAX,BOS,19,36,43,12,26,117
389,United,LAX,BOS,3,6,16,7,15,44
390,JetBlue,ORD,SEA,20,59,52,7,28,146
391,American,ORD,BOS,21,23,1,3,7,34
392,JetBlue,LAX,MIA,20,6,53,2,28,89
393,JetBlue,DFW,DEN,18,28,22,9,26,85
394,Southwest,DFW,SEA,11,43,21,3,15,82
395,JetBlue,LAX,MIA,22,0,28,0,22,50
396,Delta,DFW,SEA,0,36,28,7,5,76
397,Southwest,ORD,SEA,11,22,3,0,3,28
398,United,ORD,SEA,5,23,32,2,23,80
399,Delta,ORD,DEN,14,7,6,12,11,36
400,JetBlue,JFK,DEN,2,9,27,2,9,47
401,Delta,ATL,BOS,17,29,43,5,26,103
402,American,ORD,PHX,13,54,6,6,0,66
403,Delta,DFW,PHX,1,21,32,10,16,79
404,Southwest,JFK,MIA,4,29,26,10,4,69
405,Delta,ATL,MIA,3,48,12,14,14,88
406,JetBlue,DFW,PHX,6,20,55,11,8,94
407,Delta,LAX,BOS,5,8,31,8,0,47
408,Southwest,ATL,PHX,7,39,36,8,16,99
409,American,DFW,MIA,1,41,59,8,15,123
410,American,ORD,DEN,3,57,48,2,3,110
411,Southwest,DFW,SEA,15,35,45,9,29,118
412,American,LAX,PHX,21,48,49,9,10,116
413,Delta,LAX,DEN,5,49,48,10,12,119
414,American,DFW,BOS,6,35,44,9,8,96
415,Southwest,LAX,BOS,3,37,26,11,9,83
416,United,LAX,SEA,5,38,59,2,4,103
417,American,ATL,DEN,11,44,20,8,16,88
418,Southwest,DFW,PHX,14,45,23,5,3,76
419,JetBlue,JFK,BOS,6,21,46,10,11,88
420,JetBlue,DFW,SEA,14,51,30,2,15,98
421,Delta,ORD,PHX,16,5,18,4,11,38
422,United,ATL,BOS,6,35,36,0,1,72
423,American,JFK,SEA,11,23,11,1,0,35
424,American,JFK,SEA,2,37,5,10,13,65
425,Delta,JFK,PHX,20,58,16,5,8,87
426,American,LAX,BOS,1,26,19,0,7,52
427,American,ORD,SEA,20,55,19,1,22,97
428,Southwest,LAX,PHX,20,44,37,9,13,103
429,JetBlue,DFW,SEA,19,24,7,9,3,43
430,Delta,DFW,DEN,7,29,17,14,25,85
431,United,ORD,DEN,7,26,16,7,22,71
432,United,JFK,BOS,17,4,16,2,21,43
433,JetBlue,ATL,BOS,5,3,30,7,26,66
434,Southwest,ORD,DEN,17,0,36,10,0,46
435,Southwest,DFW,MIA,6,38,19,11,12,80
436,American,LAX,PHX,5,34,43,10,12,99
437,Delta,JFK,SEA,23,4,45,7,15,71
438,American,DFW,BOS,14,35,1,10,0,46
439,American,ATL,BOS,0,28,13,7,10,58
440,American,LAX,SEA,4,28,38,6,20,92
441,American,JFK,PHX,13,27,18,2,2,49
442,Delta,ATL,SEA,12,18,1,13,16,48
443,Delta,DFW,BOS,15,48,58,2,12,120
444,American,ORD,SEA,18,26,46,13,17,102
445,Delta,DFW,PHX,18,7,28,6,5,46
446,JetBlue,JFK,PHX,17,33,59,5,9,106
447,Delta,ATL,SEA,15,28,51,7,20,106
448,Southwest,LAX,SEA,7,20,40,10,1,71
449,Southwest,JFK,MIA,19,32,15,0,9,56
450,JetBlue,LAX,PHX,17,6,47,0,4,57
451,United,DFW,MIA,5,42,31,14,0,87
452,JetBlue,ORD,BOS,19,20,21,5,18,64
453,American,DFW,BOS,10,47,40,4,9,100
454,Delta,LAX,BOS,19,41,20,8,21,90
455,American,JFK,SEA,7,51,12,13,23,99
456,Southwest,ORD,PHX,20,46,36,10,19,111
457,Delta,ORD,BOS,23,6,6,6,3,21
458,Southwest,LAX,PHX,10,57,40,4,25,126
459,JetBlue,DFW,BOS,8,6,43,11,16,76
460,Southwest,LAX,MIA,6,29,33,5,12,79
461,United,LAX,SEA,2,5,47,2,1,55
462,Southwest,ORD,MIA,22,22,1,4,0,27
463,Delta,LAX,PHX,11,27,8,5,18,58
464,United,ORD,BOS,4,26,59,2,12,99
465,Delta,LAX,PHX,15,55,48,4,23,130
466,United,ORD,SEA,17,1,52,12,10,75
467,Southwest,DFW,MIA,14,40,5,11,10,66
468,United,ORD,BOS,15,18,0,12,7,37
469,United,DFW,PHX,4,51,1,0,11,63
470,Southwest,JFK,SEA,10,14,37,5,1,57
471,JetBlue,ATL,MIA,2,6,58,14,19,97
472,Delta,ORD,PHX,8,59,27,1,23,110
473,Delta,ATL,DEN,9,19,42,2,4,67
474,Southwest,JFK,DEN,19,55,7,3,10,75
475,Delta,ATL,BOS,15,39,2,8,24,73
476,JetBlue,ATL,BOS,23,18,5,4,25,52
477,Delta,JFK,SEA,1,18,56,13,16,103
478,United,DFW,BOS,21,28,22,12,12,74
479,JetBlue,JFK,DEN,15,53,40,0,17,110
480,Delta,ATL,BOS,16,33,16,14,7,70
481,JetBlue,ATL,BOS,10,58,34,2,6,100
482,Delta,ATL,SEA,18,4,10,0,12,26
483,American,ORD,SEA,1,44,55,6,3,108
484,Delta,LAX,MIA,11,58,15,11,27,111
485,American,ATL,SEA,18,23,56,2,18,99
486,Southwest,JFK,DEN,4,36,31,12,14,93
487,American,LAX,PHX,12,32,29,14,22,97
488,United,ORD,SEA,16,39,27,7,16,89
489,United,ATL,DEN,9,18,30,13,11,72
490,United,JFK,SEA,13,1,35,8,5,49
491,Delta,ATL,DEN,3,49,50,12,17,128
492,Southwest,JFK,BOS,11,19,37,8,18,82
493,American,ORD,MIA,22,32,44,0,21,97
494,Delta,JFK,MIA,17,7,16,7,7,37
495,United,DFW,PHX,13,53,27,13,22,115
496,JetBlue,LAX,MIA,17,17,35,2,26,80
497,JetBlue,DFW,SEA,21,44,58,7,14,123
498,Southwest,JFK,SEA,23,40,24,2,3,69
499,Southwest,ORD,MIA,1,29,9,1,1,40
500,American,LAX,PHX,12,24,55,0,7,86
501,Delta,JFK,SEA,7,35,15,9,5,64
502,JetBlue,JFK,BOS,0,23,32,9,23,87
503,Southwest,LAX,SEA,16,5,57,0,24,86
504,JetBlue,ORD,SEA,14,5,56,8,15,84
505,Southwest,LAX,BOS,11,21,21,0,21,63
506,JetBlue,LAX,DEN,6,55,54,12,2,123
507,Delta,ORD,SEA,14,29,53,13,19,114
508,Southwest,JFK,PHX,6,3,57,13,21,94
509,Southwest,ORD,PHX,15,40,9,7,26,82
510,Southwest,LAX,BOS,1,31,17,14,2,64
511,Delta,LAX,DEN,5,0,15,11,13,39
512,American,LAX,BOS,3,7,50,3,13,73
513,American,JFK,MIA,6,8,42,6,3,59
514,American,JFK,DEN,19,41,52,1,23,117
515,United,JFK,BOS,22,59,9,0,6,74
516,Southwest,ORD,BOS,10,29,2,10,19,60
517,American,LAX,PHX,9,20,6,11,12,49
518,United,JFK,DEN,17,7,53,3,27,90
519,Delta,JFK,PHX,9,36,11,4,20,71
520,American,ORD,BOS,19,14,41,5,3,63
521,JetBlue,ATL,PHX,19,31,57,12,5,105
522,Southwest,ATL,DEN,3,34,19,9,23,85
523,Delta,ORD,SEA,20,35,42,11,19,107
524,Delta,JFK,PHX,20,42,44,2,22,110
525,Delta,ORD,BOS,2,57,44,6,8,115
526,JetBlue,ATL,MIA,7,38,58,7,7,110
527,Delta,LAX,MIA,11,14,54,2,5,75
528,JetBlue,LAX,PHX,4,31,51,0,0,82
529,Delta,ORD,BOS,14,57,11,2,5,75
530,Southwest,ORD,MIA,22,10,26,13,3,52
531,United,LAX,PHX,8,46,31,7,6,90
532,JetBlue,JFK,DEN,2,4,37,9,12,62
533,Southwest,JFK,DEN,11,36,56,8,13,113
534,American,LAX,MIA,0,31,51,9,29,120
535,United,ATL,MIA,12,55,11,12,8,86
536,American,JFK,BOS,22,24,14,8,29,75
537,JetBlue,JFK,SEA,23,12,9,9,1,31
538,Southwest,DFW,MIA,5,53,45,2,3,103
539,Southwest,LAX,MIA,1,23,44,7,14,88
540,Southwest,ATL,PHX,10,14,16,14,21,65
541,Southwest,ATL,DEN,7,16,11,6,0,33
542,United,ORD,BOS,6,30,46,1,15,92
543,Southwest,JFK,PHX,16,2,3,4,8,17
544,JetBlue,ORD,MIA,1,37,58,12,7,114
545,United,ATL,SEA,17,50,46,14,13,123
546,Southwest,ATL,PHX,10,11,56,2,19,88
547,United,LAX,PHX,22,38,51,4,23,116
548,JetBlue,ORD,PHX,20,4,16,11,28,59
549,American,DFW,BOS,3,45,55,12,24,136
550,Delta,ORD,BOS,15,29,27,1,5,62
551,Delta,LAX,PHX,19,4,11,1,3,19
552,American,ORD,DEN,12,12,1,10,7,30
553,American,ATL,SEA,23,26,55,8,20,109
554,Southwest,LAX,MIA,3,30,52,14,18,114
555,JetBlue,ATL,SEA,9,3,13,3,21,40
556,Delta,DFW,MIA,22,38,34,8,5,85
557,JetBlue,DFW,DEN,20,40,36,2,0,78
558,American,ATL,DEN,14,11,21,3,10,45
559,Southwest,JFK,PHX,16,24,42,4,13,83
560,Delta,JFK,BOS,12,8,4,9,12,33
561,JetBlue,ATL,MIA,23,6,6,3,11,26
562,JetBlue,DFW,BOS,8,21,32,9,28,90
563,Southwest,ATL,SEA,22,50,49,1,21,121
564,United,ATL,DEN,2,41,4,10,8,63
565,American,LAX,PHX,19,2,6,3,29,40
566,JetBlue,DFW,MIA,7,39,35,5,5,84
567,American,JFK,BOS,21,45,56,14,10,125
568,American,ATL,SEA,19,20,32,14,7,73
569,Southwest,DFW,PHX,17,27,58,10,2,97
570,United,LAX,DEN,19,10,59,9,15,93
571,United,LAX,BOS,8,12,6,9,18,45
572,American,LAX,MIA,20,19,40,4,17,80
573,JetBlue,LAX,SEA,16,55,46,9,6,116
574,American,DFW,PHX,17,18,32,8,15,73
575,American,LAX,MIA,0,14,44,1,28,87
576,United,ORD,BOS,3,36,5,6,18,65
577,United,LAX,BOS,11,34,45,6,27,112
578,United,LAX,SEA,17,46,51,4,19,120
579,Delta,LAX,PHX,13,30,41,0,3,74
580,Delta,JFK,DEN,15,20,27,4,5,56
581,Delta,JFK,PHX,9,58,21,0,26,105
582,American,DFW,BOS,23,54,31,1,2,88
583,American,ORD,MIA,6,4,31,12,4,51
584,Delta,ORD,PHX,8,2,30,12,10,54
585,Southwest,JFK,BOS,22,21,16,3,27,67
586,Southwest,ATL,MIA,8,37,39,3,21,100
587,United,ORD,BOS,15,27,29,13,4,73
588,American,ORD,SEA,11,17,50,13,23,103
589,Delta,ATL,BOS,8,29,27,13,15,84
590,United,ORD,SEA,11,40,23,3,0,66
591,United,JFK,DEN,3,54,25,2,14,95
592,Delta,JFK,PHX,12,36,24,6,12,78
593,American,DFW,BOS,8,4,30,1,29,64
594,American,ATL,DEN,17,38,2,11,25,76
595,American,ATL,PHX,14,35,31,1,26,93
596,United,DFW,PHX,7,39,27,12,1,79
597,Southwest,JFK,BOS,0,42,48,10,3,103
598,Delta,DFW,PHX,15,43,52,4,21,120
599,Delta,DFW,BOS,19,20,29,12,16,77
600,Southwest,ORD,PHX,19,34,5,4,29,72
601,American,LAX,BOS,9,31,36,1,14,82
602,Southwest,JFK,PHX,22,35,52,14,1,102
603,United,LAX,SEA,9,11,31,2,14,58
604,American,JFK,PHX,3,17,4,12,18,51
605,Delta,ORD,BOS,13,10,22,4,8,44
606,Delta,JFK,DEN,0,49,49,5,29,132
607,Southwest,ORD,DEN,18,22,36,12,0,70
608,American,ORD,BOS,16,59,2,2,6,69
609,Southwest,JFK,SEA,23,12,24,7,10,53
610,Southwest,ATL,MIA,9,10,54,0,8,72
611,American,JFK,PHX,5,35,36,13,13,97
612,JetBlue,ATL,PHX,21,5,25,4,17,51
613,JetBlue,ORD,SEA,10,58,18,8,4,88
614,JetBlue,ORD,MIA,8,36,53,7,26,122
615,Delta,JFK,PHX,12,20,55,13,10,98
616,Southwest,LAX,PHX,23,23,37,3,29,92
617,American,DFW,BOS,18,23,15,7,3,48
618,American,LAX,MIA,6,35,40,12,24,111
619,Southwest,ATL,MIA,13,14,17,5,12,48
620,Southwest,LAX,MIA,2,24,26,1,1,52
621,JetBlue,ORD,SEA,17,7,49,12,29,97
622,Southwest,ATL,MIA,18,48,27,4,5,84
623,Southwest,DFW,DEN,0,8,4,8,15,35
624,United,JFK,SEA,19,58,23,13,6,100
625,Southwest,ORD,PHX,11,3,20,3,26,52
626,Delta,JFK,MIA,19,43,38,13,6,100
627,United,DFW,SEA,16,10,25,7,21,63
628,American,JFK,MIA,7,51,20,9,2,82
629,Southwest,ORD,PHX,7,35,11,11,25,82
630,Delta,ORD,DEN,19,9,29,5,24,67
631,Southwest,ORD,PHX,22,29,32,4,13,78
632,United,DFW,PHX,22,34,2,13,13,62
633,Southwest,DFW,DEN,14,51,58,3,9,121
634,Southwest,ATL,BOS,9,43,20,12,19,94
635,JetBlue,LAX,PHX,23,2,54,11,13,80
636,JetBlue,JFK,PHX,2,52,12,10,4,78
637,JetBlue,ORD,MIA,17,5,28,0,25,58
638,United,ORD,MIA,19,5,59,9,13,86
639,United,DFW,BOS,2,15,55,11,1,82
640,United,JFK,DEN,21,31,15,5,15,66
641,Delta,ATL,MIA,21,7,39,5,9,60
642,Delta,LAX,DEN,10,47,59,14,18,138
643,Delta,DFW,PHX,7,17,38,2,6,63
644,Delta,JFK,MIA,3,56,33,5,14,108
645,JetBlue,LAX,SEA,10,33,55,6,7,101
646,American,LAX,SEA,4,3,25,3,16,47
647,United,LAX,PHX,19,30,13,13,12,68
648,JetBlue,JFK,SEA,15,57,32,12,27,128
649,Southwest,ORD,PHX,1,41,24,2,17,84
650,JetBlue,ORD,MIA,13,48,30,3,6,87
651,Southwest,JFK,MIA,8,18,2,3,5,28
652,Southwest,DFW,MIA,20,34,44,4,28,110
653,Delta,JFK,SEA,5,46,12,8,3,69
654,United,ORD,DEN,23,40,44,3,4,91
655,United,DFW,DEN,14,1,34,1,25,61
656,Delta,JFK,SEA,10,57,34,10,13,114
657,Southwest,LAX,SEA,10,2,1,12,3,18
658,JetBlue,JFK,BOS,18,30,3,12,6,51
659,United,JFK,DEN,22,35,58,14,11,118
660,Southwest,DFW,PHX,14,3,43,8,10,64
661,Delta,ORD,BOS,19,49,7,12,29,97
662,American,JFK,DEN,16,33,44,2,4,83
663,Southwest,ATL,MIA,20,55,0,14,13,82
664,JetBlue,JFK,PHX,17,9,39,4,5,57
665,Southwest,LAX,DEN,8,33,0,9,0,42
666,American,ATL,MIA,23,45,32,13,26,116
667,Delta,DFW,MIA,7,32,9,10,26,77
668,Southwest,ORD,SEA,23,19,52,2,21,94
669,Delta,ORD,SEA,22,38,21,6,2,67
670,JetBlue,DFW,MIA,23,5,46,1,23,75
671,Delta,ORD,PHX,17,49,33,2,20,104
672,United,LAX,SEA,3,0,8,3,11,22
673,American,DFW,BOS,11,4,23,14,11,52
674,Delta,JFK,SEA,11,0,20,4,20,44
675,United,JFK,DEN,23,8,20,5,7,40
676,Delta,LAX,SEA,11,49,21,6,13,89
677,JetBlue,JFK,SEA,21,24,11,13,10,58
678,JetBlue,ORD,MIA,10,23,25,2,18,68
679,Delta,LAX,DEN,23,49,36,14,17,116
680,United,ATL,PHX,19,40,57,10,29,136
681,United,DFW,MIA,8,59,13,14,15,101
682,Southwest,ORD,DEN,17,23,11,13,22,69
683,Southwest,LAX,PHX,4,19,4,13,5,41
684,Southwest,ORD,PHX,12,38,39,9,14,100
685,American,ORD,PHX,6,19,34,12,1,66
686,Delta,JFK,BOS,9,10,3,7,22,42
687,United,ORD,PHX,2,53,34,0,22,109
688,Delta,JFK,BOS,14,57,6,6,12,81
689,United,LAX,MIA,10,3,5,6,24,38
690,United,ATL,MIA,4,10,29,9,3,51
691,United,ATL,PHX,7,52,19,7,16,94
692,American,ORD,DEN,6,50,5,14,13,82
693,Delta,ORD,BOS,5,36,22,7,22,87
694,Southwest,DFW,PHX,1,10,17,7,25,59
695,Southwest,ORD,DEN,18,15,6,1,27,49
696,Southwest,DFW,SEA,17,59,15,3,16,93
697,JetBlue,JFK,BOS,23,14,44,7,20,85
698,United,DFW,DEN,10,8,45,1,4,58
699,United,ORD,BOS,17,5,55,6,22,88
700,American,ORD,BOS,17,55,34,1,26,116
701,American,JFK,BOS,22,18,35,11,11,75
702,Southwest,JFK,PHX,23,28,8,4,20,60
703,Southwest,JFK,DEN,6,48,33,11,15,107
704,JetBlue,ORD,BOS,13,17,14,11,2,44
705,Delta,ORD,SEA,19,28,3,14,14,59
706,JetBlue,ATL,PHX,2,46,35,5,23,109
707,United,LAX,BOS,20,58,53,6,8,125
708,Delta,DFW,DEN,18,26,27,0,3,56
709,Delta,LAX,SEA,23,19,15,12,22,68
710,Delta,DFW,DEN,16,13,33,11,9,66
711,Delta,ORD,DEN,0,33,23,5,29,90
712,Delta,ORD,SEA,16,13,6,8,18,45
713,Delta,ORD,DEN,15,32,53,1,5,91
714,United,JFK,MIA,21,4,39,10,14,67
715,Southwest,LAX,BOS,13,16,15,4,21,56
716,United,DFW,BOS,6,21,41,8,18,88
717,Delta,DFW,PHX,22,11,58,2,3,74
718,American,JFK,PHX,22,1,47,1,4,53
719,Southwest,JFK,PHX,2,16,7,4,25,52
720,Southwest,ATL,DEN,19,10,4,13,18,45
721,United,ATL,DEN,21,33,54,12,24,123
722,Southwest,JFK,BOS,10,4,44,13,8,69
723,JetBlue,LAX,BOS,5,52,26,7,2,87
724,JetBlue,LAX,BOS,23,28,40,1,18,87
725,American,ATL,DEN,6,33,54,10,12,109
726,Delta,ATL,SEA,14,32,41,13,21,107
727,Delta,LAX,PHX,12,3,12,14,15,44
728,Southwest,JFK,DEN,18,32,46,8,10,96
729,JetBlue,ATL,SEA,21,31,42,14,15,102
730,JetBlue,DFW,PHX,14,11,18,0,24,53
731,JetBlue,DFW,BOS,0,27,18,1,2,48
732,United,ORD,DEN,7,35,38,8,14,95
733,Southwest,ORD,PHX,10,21,4,8,25,58
734,Delta,ATL,MIA,14,32,3,7,11,53
735,JetBlue,ATL,BOS,7,58,43,10,15,126
736,JetBlue,ATL,BOS,21,43,49,11,29,132
737,JetBlue,ATL,MIA,2,14,20,7,17,58
738,American,ATL,PHX,19,4,15,5,8,32
739,American,ATL,BOS,6,43,43,1,3,90
740,JetBlue,ATL,PHX,17,11,29,14,29,83
741,Delta,ORD,PHX,2,3,58,11,14,86
742,JetBlue,LAX,DEN,9,38,6,8,18,70
743,Delta,ORD,PHX,22,20,28,7,20,75
744,Southwest,DFW,DEN,9,37,34,12,2,85
745,United,LAX,BOS,1,51,45,4,26,126
746,Southwest,ORD,SEA,2,43,8,7,13,71
747,American,ORD,SEA,23,25,24,0,8,57
748,JetBlue,JFK,DEN,20,49,58,11,14,132
749,Southwest,LAX,MIA,1,47,29,14,9,99
750,United,DFW,DEN,19,33,54,12,17,116
751,Southwest,LAX,SEA,15,55,4,11,14,84
752,Southwest,ORD,DEN,12,22,13,0,19,54
753,Southwest,LAX,BOS,6,5,36,0,3,44
754,American,DFW,BOS,8,16,24,4,20,64
755,American,JFK,MIA,11,9,16,11,12,48
756,Delta,ORD,BOS,15,35,25,5,28,93
757,United,DFW,MIA,9,51,35,11,4,101
758,American,ATL,MIA,18,18,37,14,21,90
759,JetBlue,JFK,MIA,11,3,56,1,24,84
760,Delta,ORD,PHX,22,25,19,4,9,57
761,Delta,DFW,DEN,10,54,7,11,16,88
762,Delta,JFK,SEA,2,33,37,0,29,99
763,American,ORD,BOS,2,30,49,12,8,99
764,JetBlue,LAX,SEA,13,43,48,10,2,103
765,United,DFW,MIA,14,3,49,6,10,68
766,Southwest,JFK,SEA,5,36,6,10,8,60
767,United,ORD,MIA,22,6,45,4,21,76
768,Delta,LAX,MIA,14,52,29,0,16,97
769,Delta,ORD,MIA,12,10,40,5,11,66
770,JetBlue,ATL,MIA,18,31,57,14,28,130
771,JetBlue,LAX,MIA,1,43,11,11,29,94
772,United,DFW,BOS,21,15,29,7,9,60
773,United,LAX,MIA,19,51,5,13,20,89
774,Delta,JFK,PHX,23,45,46,8,0,99
775,United,ATL,BOS,20,21,22,6,3,52
776,JetBlue,ATL,SEA,16,18,27,5,10,60
777,JetBlue,ORD,SEA,12,10,14,2,9,35
778,Delta,JFK,DEN,22,43,30,6,26,105
779,JetBlue,DFW,BOS,14,48,13,6,25,92
780,Delta,ATL,DEN,2,52,34,13,5,104
781,United,JFK,DEN,9,35,28,10,23,96
782,United,JFK,SEA,22,39,39,8,27,113
783,Southwest,JFK,DEN,21,26,6,12,6,50
784,JetBlue,JFK,SEA,2,9,21,9,5,44
785,Southwest,LAX,PHX,11,45,5,14,13,77
786,JetBlue,ORD,DEN,2,23,17,11,12,63
787,Southwest,ORD,DEN,11,57,43,8,9,117
788,Delta,ATL,SEA,10,38,56,12,16,122
789,Delta,LAX,DEN,3,0,46,12,24,82
790,United,ORD,MIA,5,28,41,9,6,84
791,JetBlue,DFW,BOS,13,43,13,13,22,91
792,American,ATL,SEA,1,22,59,10,22,113
793,JetBlue,ATL,BOS,16,26,3,12,6,47
794,Delta,ATL,SEA,19,8,47,9,9,73
795,American,DFW,DEN,14,7,2,7,17,33
796,United,LAX,BOS,6,27,9,8,27,71
797,American,JFK,SEA,11,8,37,4,16,65
798,Delta,LAX,SEA,14,16,6,8,3,33
799,JetBlue,ORD,MIA,23,58,35,14,7,114
800,Southwest,ORD,BOS,23,28,38,11,28,105
801,Southwest,JFK,MIA,7,27,53,10,15,105
802,United,ATL,SEA,10,5,20,5,29,59
803,Southwest,JFK,SEA,15,33,42,6,7,88
804,American,JFK,BOS,15,32,21,0,8,61
805,Southwest,JFK,BOS,10,41,17,7,29,94
806,Southwest,ATL,MIA,5,28,58,2,25,113
807,Southwest,JFK,DEN,21,45,58,10,8,121
808,Delta,ATL,MIA,4,16,23,12,22,73
809,JetBlue,DFW,SEA,6,52,50,2,6,110
810,Delta,LAX,PHX,8,56,57,2,17,132
811,American,ORD,BOS,11,36,7,0,5,48
812,American,ORD,PHX,13,36,43,4,12,95
813,Southwest,LAX,MIA,15,28,0,13,1,42
814,Delta,ORD,SEA,21,20,17,10,1,48
815,American,ORD,SEA,14,13,51,10,28,102
816,United,DFW,PHX,18,19,6,12,19,56
817,JetBlue,JFK,SEA,11,33,39,6,12,90
818,American,LAX,PHX,8,15,42,6,13,76
819,Delta,JFK,PHX,1,8,9,12,20,49
820,Southwest,LAX,BOS,11,49,24,9,15,97
821,Southwest,ORD,SEA,7,11,40,13,25,89
822,Delta,ORD,PHX,1,11,56,1,21,89
823,American,JFK,SEA,20,10,8,3,28,49
824,JetBlue,ORD,BOS,5,49,29,11,1,90
825,JetBlue,LAX,PHX,11,4,49,11,2,66
826,Delta,JFK,BOS,5,58,14,9,19,100
827,American,ORD,PHX,4,54,55,6,29,144
828,Delta,LAX,BOS,0,42,27,11,9,89
829,United,JFK,BOS,17,31,8,11,7,57
830,JetBlue,ATL,PHX,3,40,43,6,18,107
831,United,ATL,SEA,8,44,36,12,13,105
832,American,ATL,PHX,12,49,23,9,29,110
833,JetBlue,DFW,DEN,23,44,7,10,12,73
834,American,JFK,SEA,19,15,11,2,23,51
835,United,ORD,DEN,14,2,42,12,5,61
836,United,ATL,BOS,23,44,31,7,18,100
837,American,ORD,DEN,13,5,4,11,5,25
838,American,JFK,BOS,0,10,11,14,17,52
839,Southwest,ATL,DEN,10,55,13,7,23,98
840,Southwest,LAX,SEA,6,31,51,3,18,103
841,United,JFK,DEN,22,0,21,3,6,30
842,Southwest,ATL,BOS,0,25,4,12,2,43
843,American,ORD,SEA,17,14,31,9,22,76
844,Southwest,ATL,PHX,1,13,48,8,14,83
845,United,ORD,DEN,20,49,50,1,0,100
846,Southwest,ATL,BOS,17,23,57,8,15,103
847,American,DFW,BOS,23,48,56,5,0,109
848,Southwest,ATL,BOS,12,45,20,7,3,75
849,Delta,JFK,SEA,3,9,56,6,24,95
850,United,ORD,PHX,0,21,33,10,14,78
851,JetBlue,JFK,SEA,16,4,4,11,17,36
852,Delta,DFW,PHX,4,29,53,4,2,88
853,JetBlue,DFW,BOS,11,9,48,9,9,75
854,Southwest,ORD,BOS,20,32,43,13,6,94
855,Delta,ATL,PHX,0,23,29,6,25,83
856,United,JFK,PHX,23,35,7,5,17,64
857,JetBlue,DFW,MIA,16,2,24,5,10,41
858,American,DFW,MIA,19,4,59,12,7,82
859,American,ATL,BOS,4,2,1,14,23,40
860,American,ATL,PHX,23,5,48,4,10,67
861,Southwest,DFW,MIA,3,11,20,1,15,47
862,JetBlue,JFK,SEA,20,38,16,3,29,86
863,JetBlue,JFK,MIA,22,21,52,8,12,93
864,American,DFW,SEA,22,33,42,8,17,100
865,American,ORD,BOS,7,58,2,9,21,90
866,Southwest,DFW,SEA,0,1,55,7,13,76
867,Delta,LAX,BOS,15,17,6,12,29,64
868,Southwest,ORD,PHX,23,49,44,6,29,128
869,United,DFW,PHX,0,1,16,3,1,21
870,American,LAX,PHX,12,0,2,10,9,21
871,Southwest,JFK,DEN,2,55,5,6,0,66
872,Delta,JFK,SEA,12,14,12,6,16,48
873,JetBlue,ATL,MIA,7,17,11,12,18,58
874,Delta,JFK,SEA,14,54,46,11,21,132
875,Delta,DFW,DEN,6,52,32,12,25,121
876,American,ORD,PHX,21,48,44,1,9,102
877,Delta,ORD,DEN,4,20,3,8,15,46
878,United,JFK,SEA,22,39,5,8,26,78
879,JetBlue,JFK,DEN,16,5,50,3,6,64
880,Southwest,JFK,BOS,17,54,19,12,15,100
881,Southwest,LAX,SEA,9,21,49,10,8,88
882,United,LAX,SEA,2,24,25,1,28,78
883,Delta,JFK,DEN,8,49,45,4,14,112
884,Delta,JFK,DEN,10,48,29,14,15,106
885,United,JFK,DEN,9,21,21,0,15,57
886,United,ORD,PHX,7,46,34,14,11,105
887,Delta,ATL,SEA,17,42,3,5,18,68
888,JetBlue,LAX,PHX,4,35,8,13,26,82
889,Southwest,LAX,DEN,4,23,48,14,28,113
890,Southwest,LAX,BOS,19,35,33,7,16,91
891,United,LAX,MIA,13,50,22,14,9,95
892,United,ATL,BOS,18,40,38,4,13,95
893,Delta,LAX,DEN,0,27,53,9,25,114
894,Delta,DFW,SEA,13,6,25,11,10,52
895,United,ORD,PHX,14,22,54,1,2,79
896,American,ORD,MIA,1,32,52,10,20,114
897,Southwest,LAX,BOS,5,40,7,14,25,86
898,Southwest,DFW,PHX,12,22,28,13,24,87
899,American,LAX,SEA,1,45,14,4,8,71
900,United,DFW,BOS,4,27,17,5,16,65
901,United,ATL,PHX,2,28,45,10,5,88
902,United,LAX,DEN,23,0,44,12,24,80
903,Southwest,DFW,DEN,14,54,14,0,26,94
904,American,DFW,DEN,2,24,7,9,5,45
905,American,ORD,MIA,15,57,58,5,3,123
906,JetBlue,JFK,MIA,9,26,31,6,10,73
907,JetBlue,LAX,MIA,2,27,30,9,5,71
908,Southwest,DFW,SEA,22,29,4,3,23,59
909,American,ATL,PHX,6,24,33,11,2,70
910,American,DFW,PHX,6,12,56,11,12,91
911,American,JFK,MIA,20,28,30,12,0,70
912,Delta,DFW,SEA,23,12,37,11,28,88
913,Delta,JFK,BOS,1,56,50,4,1,111
914,Southwest,DFW,SEA,1,20,45,4,5,74
915,Delta,DFW,BOS,21,43,42,2,3,90
916,United,ATL,SEA,2,11,49,13,25,98
917,JetBlue,ATL,PHX,12,49,11,3,16,79
918,Southwest,ATL,DEN,11,46,6,7,0,59
919,American,ATL,PHX,18,47,38,8,28,121
920,United,DFW,DEN,11,27,35,11,12,85
921,American,ORD,DEN,5,21,16,9,25,71
922,United,ORD,DEN,20,20,11,12,23,66
923,JetBlue,LAX,MIA,21,2,55,10,13,80
924,United,DFW,SEA,11,31,58,4,3,96
925,American,LAX,DEN,6,13,44,3,24,84
926,Delta,ATL,MIA,4,7,56,9,9,81
927,Delta,JFK,MIA,16,20,25,6,9,60
928,JetBlue,DFW,DEN,5,34,30,2,24,90
929,American,ORD,DEN,22,43,52,7,7,109
930,American,ORD,PHX,0,10,0,12,10,32
931,American,LAX,DEN,20,7,47,9,27,90
932,Delta,ATL,PHX,20,46,51,14,19,130
933,JetBlue,JFK,MIA,18,27,27,4,19,77
934,JetBlue,LAX,PHX,17,33,29,1,26,89
935,Southwest,ATL,BOS,22,28,49,9,25,111
936,United,ATL,MIA,21,17,21,5,9,52
937,Southwest,ATL,SEA,20,6,2,14,18,40
938,Southwest,JFK,MIA,11,3,5,2,23,33
939,American,DFW,MIA,8,46,17,0,22,85
940,Delta,DFW,DEN,3,27,2,5,6,40
941,American,DFW,MIA,2,18,3,14,19,54
942,JetBlue,ORD,BOS,10,6,54,2,6,68
943,Delta,LAX,PHX,19,50,53,11,9,123
944,American,JFK,DEN,6,10,44,10,14,78
945,Delta,LAX,BOS,8,20,21,11,24,76
946,Delta,ATL,PHX,3,57,43,0,25,125
947,Delta,JFK,MIA,7,54,37,6,20,117
948,Delta,LAX,PHX,13,0,38,12,29,79
949,JetBlue,JFK,MIA,9,12,37,10,13,72
950,Delta,ATL,DEN,14,45,18,0,4,67
951,Delta,ATL,PHX,12,35,55,10,16,116
952,JetBlue,DFW,DEN,7,6,46,10,14,76
953,Southwest,DFW,SEA,15,10,42,2,13,67
954,Delta,DFW,BOS,8,53,10,0,17,80
955,Southwest,JFK,PHX,21,27,33,4,29,93
956,United,ORD,SEA,13,36,37,2,29,104
957,JetBlue,DFW,DEN,1,46,55,10,2,113
958,United,ATL,SEA,0,36,15,12,4,67
959,Southwest,LAX,MIA,0,5,40,10,16,71
960,American,LAX,MIA,4,57,32,9,27,125
961,American,DFW,MIA,22,59,7,2,28,96
962,American,ATL,DEN,18,8,34,10,20,72
963,United,ORD,MIA,18,16,21,7,15,59
964,American,LAX,SEA,23,55,13,6,18,92
965,American,LAX,DEN,11,53,20,6,5,84
966,United,ATL,PHX,17,20,11,11,6,48
967,Southwest,LAX,SEA,13,47,27,2,25,101
968,JetBlue,ATL,DEN,3,57,11,1,11,80
969,JetBlue,LAX,SEA,0,28,57,6,20,111
970,JetBlue,JFK,SEA,23,24,23,10,8,65
971,Southwest,ORD,BOS,0,54,56,13,11,134
972,American,JFK,PHX,6,36,23,8,20,87
973,United,ATL,BOS,7,27,24,3,14,68
974,JetBlue,DFW,MIA,19,5,48,11,3,67
975,JetBlue,ORD,MIA,12,13,0,10,25,48
976,United,ATL,PHX,5,40,8,0,18,66
977,American,DFW,BOS,18,25,44,8,22,99
978,JetBlue,LAX,SEA,22,57,18,8,12,95
979,JetBlue,JFK,PHX,8,9,1,2,6,18
980,United,ORD,BOS,14,2,19,2,24,47
981,Southwest,ORD,SEA,21,34,50,0,7,91
982,Delta,ORD,PHX,14,25,23,7,23,78
983,American,ORD,SEA,3,0,6,12,13,31
984,American,LAX,SEA,9,47,9,10,23,89
985,Southwest,ORD,DEN,16,56,35,4,19,114
986,American,JFK,DEN,22,40,6,3,7,56
987,United,DFW,MIA,5,3,24,6,5,38
988,American,JFK,PHX,23,13,37,12,5,67
989,Delta,ATL,DEN,11,48,36,8,25,117
990,Delta,DFW,SEA,19,24,37,0,6,67
991,Southwest,LAX,SEA,3,8,45,2,29,84
992,American,ORD,PHX,19,36,2,11,4,53
993,American,ATL,MIA,18,3,59,6,21,89
994,Delta,JFK,SEA,21,5,6,4,1,16
995,Delta,DFW,MIA,11,16,15,5,25,61
996,JetBlue,JFK,PHX,22,45,28,7,22,102
997,Southwest,ATL,PHX,5,35,23,10,4,72
998,JetBlue,ATL,PHX,20,2,55,10,8,75
999,JetBlue,DFW,SEA,18,23,13,1,5,42
1000,Delta,DFW,PHX,22,6,14,1,1,22
1001,Southwest,JFK,DEN,2,18,37,7,5,67
1002,Southwest,DFW,DEN,20,47,9,9,6,71
1003,American,ORD,DEN,0,59,10,11,20,100
1004,United,LAX,SEA,21,37,16,11,27,91
1005,United,ATL,SEA,5,5,37,13,9,64
1006,Delta,LAX,BOS,22,5,49,13,15,82
1007,Delta,DFW,MIA,7,17,16,10,21,64
1008,Delta,JFK,PHX,2,30,34,5,1,70
1009,United,LAX,BOS,8,16,32,2,0,50
1010,Delta,ATL,BOS,22,47,2,10,18,77
1011,American,ATL,DEN,16,24,3,10,19,56
1012,United,JFK,SEA,19,11,3,4,20,38
1013,JetBlue,DFW,MIA,13,54,17,3,3,77
1014,American,JFK,BOS,23,3,15,2,1,21
1015,Southwest,DFW,PHX,16,53,12,3,16,84
1016,JetBlue,ATL,MIA,2,33,0,4,4,41
1017,United,LAX,DEN,0,23,1,2,28,54
1018,United,ORD,PHX,21,25,58,13,27,123
1019,United,LAX,MIA,13,49,2,8,28,87
1020,Delta,ORD,MIA,14,11,39,14,4,68
1021,Southwest,LAX,SEA,6,32,14,10,21,77
1022,United,ATL,DEN,3,39,11,8,21,79
1023,Southwest,ATL,BOS,5,50,47,0,19,116
1024,American,JFK,SEA,18,34,11,12,0,57
1025,United,LAX,PHX,23,24,4,13,29,70
1026,American,ORD,PHX,2,28,11,10,22,71
1027,Delta,ORD,BOS,21,54,24,5,17,100
1028,Southwest,DFW,PHX,21,42,20,11,6,79
1029,JetBlue,LAX,SEA,7,29,25,1,27,82
1030,Southwest,ATL,SEA,1,44,26,2,20,92
1031,JetBlue,LAX,SEA,5,51,21,2,15,89
1032,JetBlue,ATL,SEA,21,7,24,2,24,57
1033,American,DFW,MIA,18,8,45,12,20,85
1034,Delta,JFK,BOS,12,41,2,10,9,62
1035,American,ORD,SEA,13,41,27,8,7,83
1036,JetBlue,DFW,SEA,4,49,44,13,22,128
1037,Delta,DFW,DEN,22,39,3,12,12,66
1038,United,DFW,PHX,8,12,18,0,24,54
1039,JetBlue,ATL,BOS,0,53,52,13,17,135
1040,Southwest,JFK,PHX,6,42,38,4,25,109
1041,Southwest,LAX,BOS,5,16,4,1,24,45
1042,Southwest,JFK,DEN,4,3,2,1,3,9
1043,Delta,ATL,PHX,14,55,30,1,0,86
1044,Southwest,ORD,MIA,21,19,46,14,23,102
1045,Delta,LAX,PHX,4,1,55,13,10,79
1046,American,LAX,PHX,3,26,6,10,12,54
1047,United,ATL,SEA,16,29,52,6,8,95
1048,United,ATL,SEA,21,5,39,0,17,61
1049,Delta,ORD,SEA,14,13,26,9,13,61
1050,United,ATL,DEN,17,5,49,4,5,63
1051,JetBlue,ORD,SEA,3,26,10,5,13,54
1052,United,JFK,PHX,13,23,26,0,23,72
1053,United,DFW,BOS,6,57,44,0,24,125
1054,Southwest,LAX,DEN,5,26,30,7,16,79
1055,United,DFW,PHX,21,39,21,1,7,68
1056,Delta,JFK,BOS,23,2,37,1,10,50
1057,Southwest,DFW,PHX,3,35,40,0,16,91
1058,United,JFK,SEA,12,54,42,2,28,126
1059,JetBlue,ATL,BOS,2,23,39,12,10,84
1060,Delta,ORD,SEA,14,58,6,8,20,92
1061,American,LAX,DEN,6,46,58,3,4,111
1062,American,JFK,PHX,4,27,36,7,0,70
1063,Southwest,ATL,BOS,17,37,14,10,2,63
1064,United,JFK,DEN,17,41,32,1,28,102
1065,JetBlue,ORD,PHX,5,7,29,8,10,54
1066,JetBlue,LAX,DEN,10,22,26,2,10,60
1067,JetBlue,LAX,DEN,18,8,26,4,11,49
1068,Delta,ATL,BOS,18,6,14,10,2,32
1069,American,LAX,PHX,8,33,34,13,4,84
1070,American,DFW,SEA,20,27,32,14,13,86
1071,Southwest,JFK,SEA,16,50,19,14,1,84
1072,JetBlue,JFK,DEN,18,8,26,9,29,72
1073,United,LAX,DEN,1,41,44,3,15,103
1074,United,ATL,BOS,7,40,16,9,5,70
1075,Southwest,ORD,PHX,18,47,49,8,27,131
1076,American,DFW,DEN,4,51,54,9,18,132
1077,JetBlue,JFK,BOS,13,26,7,1,16,50
1078,JetBlue,ATL,DEN,23,8,9,13,5,35
1079,Delta,ATL,SEA,12,36,55,9,20,120
1080,JetBlue,ORD,PHX,13,51,27,7,27,112
1081,Delta,ATL,BOS,2,8,42,10,0,60
1082,Southwest,DFW,MIA,13,37,24,4,6,71
1083,JetBlue,ORD,SEA,16,21,5,5,18,49
1084,Southwest,ATL,DEN,2,28,44,0,3,75
1085,JetBlue,LAX,BOS,6,31,26,5,13,75
1086,American,JFK,PHX,17,53,38,2,7,100
1087,American,JFK,BOS,17,31,33,1,3,68
1088,Southwest,JFK,MIA,10,28,18,4,29,79
1089,United,ORD,DEN,21,3,42,11,15,71
1090,JetBlue,ORD,MIA,14,33,8,9,25,75
1091,Southwest,LAX,SEA,20,9,38,3,29,79
1092,Southwest,DFW,BOS,22,33,56,6,8,103
1093,American,DFW,DEN,8,51,7,2,13,73
1094,Southwest,DFW,SEA,3,15,55,8,1,79
1095,Southwest,ATL,MIA,5,56,41,12,10,119
1096,United,LAX,SEA,9,14,43,2,7,66
1097,JetBlue,LAX,SEA,0,48,10,10,11,79
1098,Delta,JFK,MIA,16,16,55,8,11,90
1099,Southwest,LAX,PHX,5,40,9,5,14,68
1100,Delta,DFW,DEN,12,12,52,10,4,78
1101,United,LAX,PHX,0,1,59,3,20,83
1102,Southwest,JFK,PHX,17,19,38,4,24,85
1103,Delta,LAX,PHX,3,14,35,9,23,81
1104,United,LAX,DEN,21,22,58,9,20,109
1105,JetBlue,JFK,SEA,7,30,48,14,8,100
1106,Delta,JFK,PHX,7,20,45,0,27,92
1107,American,ATL,DEN,2,20,36,6,9,71
1108,United,JFK,SEA,7,10,15,13,6,44
1109,Southwest,LAX,DEN,22,47,19,11,8,85
1110,United,DFW,BOS,9,52,36,8,19,115
1111,JetBlue,JFK,PHX,7,49,9,14,6,78
1112,American,LAX,DEN,18,25,50,10,15,100
1113,Delta,JFK,BOS,17,47,32,10,9,98
1114,Delta,JFK,DEN,5,2,45,2,20,69
1115,Delta,DFW,DEN,17,13,59,12,23,107
1116,Southwest,JFK,MIA,22,23,28,10,15,76
1117,Delta,LAX,DEN,14,45,20,7,14,86
1118,United,LAX,SEA,18,14,20,1,28,63
1119,Southwest,ORD,PHX,13,16,59,13,2,90
1120,Southwest,ATL,MIA,2,24,44,1,14,83
1121,American,ORD,SEA,17,46,48,0,27,121
1122,Delta,LAX,PHX,5,6,33,0,25,64
1123,United,DFW,SEA,2,24,57,9,18,108
1124,Delta,DFW,PHX,4,52,51,11,5,119
1125,Southwest,JFK,BOS,0,32,57,0,5,94
1126,JetBlue,ATL,MIA,11,40,20,14,12,86
1127,Southwest,DFW,MIA,5,55,20,13,18,106
1128,United,ORD,MIA,12,32,17,8,22,79
1129,Delta,LAX,BOS,18,36,31,7,17,91
1130,Southwest,JFK,PHX,3,33,30,6,10,79
1131,Southwest,LAX,MIA,2,48,12,10,7,77
1132,Southwest,ATL,DEN,19,49,48,2,4,103
1133,JetBlue,DFW,MIA,21,41,43,11,10,105
1134,United,ATL,SEA,8,45,12,9,22,88
1135,American,LAX,MIA,14,26,1,8,22,57
1136,Southwest,ORD,DEN,2,52,53,13,4,122
1137,Southwest,LAX,DEN,10,41,42,2,18,103
1138,American,LAX,DEN,12,45,4,7,22,78
1139,Southwest,JFK,MIA,20,36,39,12,26,113
1140,Delta,LAX,SEA,16,12,49,14,12,87
1141,Delta,JFK,PHX,22,5,25,1,10,41
1142,JetBlue,LAX,DEN,3,19,8,5,13,45
1143,American,LAX,MIA,10,30,24,0,16,70
1144,United,ATL,BOS,17,31,10,5,26,72
1145,Southwest,ORD,DEN,17,14,10,12,0,36
1146,JetBlue,ATL,BOS,13,48,4,2,21,75
1147,American,DFW,SEA,14,30,35,2,2,69
1148,JetBlue,ORD,MIA,3,22,57,13,27,119
1149,United,DFW,SEA,15,22,20,14,4,60
1150,Southwest,JFK,MIA,17,9,14,9,6,38
1151,Southwest,DFW,SEA,6,41,29,10,21,101
1152,American,LAX,MIA,8,53,1,5,29,88
1153,JetBlue,JFK,MIA,17,1,0,11,6,18
1154,United,ORD,PHX,21,25,10,3,26,64
1155,United,DFW,SEA,2,25,43,8,1,77
1156,United,ORD,BOS,1,34,8,8,15,65
1157,JetBlue,ATL,BOS,7,1,2,3,6,12
1158,American,ATL,DEN,5,16,56,12,17,101
1159,JetBlue,JFK,MIA,12,22,38,5,1,66
1160,United,ATL,BOS,23,15,45,2,3,65
1161,JetBlue,ORD,MIA,9,6,52,5,1,64
1162,Southwest,JFK,BOS,23,35,41,12,4,92
1163,Delta,ORD,PHX,7,1,26,0,10,37
1164,Delta,ORD,SEA,19,4,27,0,0,31
1165,JetBlue,ATL,SEA,16,18,0,7,9,34
1166,JetBlue,JFK,BOS,19,40,20,7,15,82
1167,Southwest,JFK,MIA,20,12,57,9,19,97
1168,Delta,DFW,DEN,1,2,29,5,8,44
1169,United,JFK,PHX,19,41,4,2,26,73
1170,American,ATL,BOS,14,11,47,2,13,73
1171,JetBlue,ORD,DEN,17,41,1,4,9,55
1172,Delta,ATL,DEN,6,21,38,8,20,87
1173,United,LAX,PHX,23,33,32,1,16,82
1174,Southwest,DFW,MIA,14,13,50,9,8,80
1175,Southwest,LAX,PHX,8,46,55,5,28,134
1176,Delta,JFK,SEA,11,32,46,13,17,108
1177,Southwest,DFW,MIA,17,38,42,12,21,113
1178,JetBlue,ATL,SEA,3,28,4,5,8,45
1179,Delta,ORD,DEN,12,30,8,12,7,57
1180,JetBlue,ORD,SEA,5,44,57,7,11,119
1181,United,JFK,PHX,4,26,5,10,12,53
1182,Southwest,JFK,MIA,21,12,44,5,11,72
1183,JetBlue,ATL,MIA,13,17,36,1,19,73
1184,American,JFK,SEA,2,6,42,2,6,56
1185,Southwest,DFW,SEA,7,3,30,7,24,64
1186,JetBlue,ATL,DEN,8,58,49,1,15,123
1187,American,LAX,SEA,20,38,20,9,9,76
1188,Delta,ATL,SEA,3,31,27,12,5,75
1189,JetBlue,JFK,DEN,20,20,18,13,16,67
1190,JetBlue,LAX,MIA,7,13,36,6,9,64
1191,United,LAX,SEA,13,20,46,13,11,90
1192,Southwest,DFW,MIA,18,49,40,13,16,118
1193,Delta,DFW,DEN,5,49,47,1,29,126
1194,United,DFW,PHX,2,47,31,14,9,101
1195,Southwest,ORD,SEA,4,56,46,0,2,104
1196,Southwest,DFW,DEN,14,23,33,8,8,72
1197,Delta,LAX,SEA,7,6,48,0,21,75
1198,JetBlue,ORD,DEN,20,27,26,1,14,68
1199,United,ATL,BOS,8,55,13,10,3,81
1200,United,ORD,MIA,23,9,59,12,11,91
1201,American,LAX,MIA,17,50,44,12,21,127
1202,American,DFW,MIA,3,38,10,11,12,71
1203,JetBlue,LAX,MIA,8,27,34,0,14,75
1204,United,JFK,DEN,21,35,6,3,27,71
1205,JetBlue,JFK,BOS,16,42,3,8,0,53
1206,United,JFK,DEN,20,27,17,1,16,61
1207,American,JFK,PHX,7,54,26,14,8,102
1208,Southwest,LAX,SEA,18,58,4,7,20,89
1209,JetBlue,ATL,SEA,10,52,10,8,19,89
1210,Southwest,JFK,PHX,9,1,48,0,26,75
1211,JetBlue,DFW,DEN,13,53,7,3,4,67
1212,Delta,JFK,SEA,16,0,6,14,20,40
1213,American,DFW,DEN,2,47,28,8,17,100
1214,Delta,JFK,DEN,4,14,41,9,6,70
1215,American,ORD,SEA,18,3,34,6,7,50
1216,United,ATL,BOS,10,0,31,1,27,59
1217,Southwest,ORD,MIA,13,10,20,2,12,44
1218,Delta,DFW,MIA,9,11,14,9,19,53
1219,JetBlue,DFW,PHX,9,17,49,14,5,85
1220,American,LAX,PHX,1,0,8,8,23,39
1221,Delta,DFW,PHX,10,44,12,4,22,82
1222,Delta,ORD,SEA,19,16,0,6,9,31
1223,United,DFW,MIA,23,23,3,4,9,39
1224,Southwest,ORD,BOS,23,18,19,1,27,65
1225,American,DFW,DEN,21,59,37,4,28,128
1226,JetBlue,DFW,SEA,4,7,41,7,24,79
1227,Delta,DFW,BOS,21,7,12,7,9,35
1228,American,DFW,PHX,15,32,37,2,21,92
1229,Delta,ATL,BOS,14,8,44,6,1,59
1230,JetBlue,DFW,DEN,19,33,11,13,15,72
1231,Delta,ATL,SEA,2,18,39,13,23,93
1232,JetBlue,LAX,DEN,0,21,36,7,13,77
1233,Southwest,ORD,SEA,21,57,14,11,25,107
1234,United,LAX,DEN,8,52,55,0,13,120
1235,American,LAX,PHX,20,51,55,6,25,137
1236,Southwest,DFW,PHX,23,52,41,7,11,111
1237,American,LAX,MIA,13,25,56,0,24,105
1238,Delta,JFK,SEA,4,52,42,4,2,100
1239,United,ATL,SEA,15,46,37,7,14,104
1240,American,ATL,DEN,19,35,2,2,4,43
1241,Delta,DFW,DEN,13,44,7,10,14,75
1242,Delta,ORD,SEA,19,34,34,9,21,98
1243,Southwest,LAX,MIA,18,41,32,0,14,87
1244,United,JFK,SEA,16,4,12,5,2,23
1245,Southwest,DFW,PHX,20,12,29,0,6,47
1246,United,ATL,PHX,20,30,10,1,9,50
1247,American,ORD,SEA,11,11,5,6,13,35
1248,Southwest,JFK,PHX,2,3,41,14,1,59
1249,JetBlue,JFK,BOS,13,23,51,8,13,95
1250,Southwest,LAX,PHX,23,51,14,5,26,96
1251,JetBlue,DFW,MIA,19,20,30,6,25,81
1252,JetBlue,LAX,SEA,18,27,5,13,29,74
1253,JetBlue,JFK,PHX,0,53,59,3,2,117
1254,Delta,ORD,DEN,10,19,48,10,28,105
1255,United,DFW,SEA,12,27,49,13,5,94
1256,JetBlue,DFW,SEA,1,39,49,7,17,112
1257,Southwest,ATL,PHX,15,24,22,10,26,82
1258,American,DFW,BOS,4,57,24,14,11,106
1259,American,JFK,MIA,19,41,28,11,2,82
1260,Delta,DFW,DEN,14,3,28,8,22,61
1261,United,LAX,MIA,4,26,35,8,10,79
1262,JetBlue,ATL,SEA,3,47,51,14,26,138
1263,JetBlue,ORD,BOS,2,47,19,10,29,105
1264,JetBlue,DFW,MIA,3,43,31,14,1,89
1265,Southwest,ATL,DEN,8,30,24,3,9,66
1266,Delta,JFK,PHX,20,4,50,14,27,95
1267,United,JFK,MIA,1,30,1,14,22,67
1268,Southwest,ORD,SEA,19,12,27,1,1,41
1269,Delta,LAX,MIA,17,13,39,4,2,58
1270,United,ORD,DEN,7,43,36,6,26,111
1271,Delta,LAX,PHX,18,34,28,0,21,83
1272,Southwest,ATL,DEN,6,11,21,10,24,66
1273,Southwest,JFK,SEA,5,4,8,12,23,47
1274,Southwest,JFK,PHX,12,10,25,13,29,77
1275,American,DFW,MIA,21,46,8,11,0,65
1276,Southwest,DFW,BOS,9,34,54,8,11,107
1277,American,ORD,BOS,23,4,41,7,13,65
1278,JetBlue,JFK,DEN,8,52,43,6,28,129
1279,American,JFK,SEA,18,43,50,14,1,108
1280,Delta,LAX,PHX,11,34,27,0,24,85
1281,Delta,JFK,DEN,22,34,31,14,29,108
1282,United,LAX,MIA,15,22,20,5,15,62
1283,United,JFK,BOS,23,24,53,2,24,103
1284,Southwest,JFK,MIA,23,49,17,11,5,82
1285,JetBlue,ATL,BOS,13,34,51,0,26,111
1286,Southwest,DFW,PHX,19,4,1,0,11,16
1287,American,LAX,PHX,23,41,15,10,28,94
1288,United,ORD,SEA,0,35,31,11,27,104
1289,JetBlue,ORD,DEN,2,40,38,13,2,93
1290,Southwest,DFW,SEA,10,10,0,7,10,27
1291,United,ORD,PHX,13,51,57,6,7,121
1292,Southwest,LAX,BOS,18,27,43,13,25,108
1293,American,ORD,PHX,16,16,31,10,9,66
1294,United,DFW,PHX,22,23,29,6,26,84
1295,JetBlue,DFW,DEN,8,43,27,6,3,79
1296,American,ATL,BOS,20,10,38,0,15,63
1297,Delta,JFK,PHX,12,49,8,1,25,83
1298,Southwest,ORD,BOS,3,41,33,1,27,102
1299,Delta,JFK,DEN,18,9,59,14,22,104
1300,Delta,DFW,SEA,11,1,22,4,7,34
1301,Southwest,DFW,MIA,14,1,54,10,17,82
1302,American,LAX,SEA,6,15,2,12,5,34
1303,Southwest,LAX,BOS,13,52,42,5,23,122
1304,American,DFW,BOS,22,0,27,2,19,48
1305,American,ATL,PHX,1,14,42,2,29,87
1306,JetBlue,ORD,MIA,8,49,45,2,28,124
1307,United,DFW,MIA,13,2,32,9,16,59
1308,Southwest,ATL,SEA,7,57,29,4,17,107
1309,American,ATL,MIA,14,57,33,5,6,101
1310,American,LAX,BOS,22,32,21,0,0,53
1311,United,ATL,SEA,17,50,58,7,11,126
1312,American,JFK,DEN,13,44,11,8,18,81
1313,Southwest,DFW,BOS,17,24,26,10,28,88
1314,JetBlue,LAX,PHX,10,27,6,11,2,46
1315,United,DFW,SEA,15,30,13,3,8,54
1316,United,ATL,PHX,9,58,37,6,18,119
1317,American,ORD,PHX,16,14,19,6,28,67
1318,Delta,JFK,DEN,20,35,22,13,16,86
1319,American,LAX,DEN,21,43,58,8,14,123
1320,United,ORD,PHX,8,30,57,14,10,111
1321,JetBlue,ATL,BOS,5,7,31,4,29,71
1322,United,ORD,PHX,20,52,39,11,29,131
1323,United,LAX,SEA,2,0,54,3,9,66
1324,Southwest,DFW,BOS,4,14,39,7,23,83
1325,Southwest,JFK,SEA,18,44,51,7,13,115
1326,Delta,LAX,BOS,19,13,9,12,24,58
1327,Delta,DFW,SEA,15,54,42,12,11,119
1328,Delta,ATL,BOS,7,30,27,3,0,60
1329,Delta,DFW,BOS,10,4,24,11,27,66
1330,United,LAX,DEN,19,54,47,12,14,127
1331,United,ATL,MIA,13,55,30,10,2,97
1332,Southwest,JFK,PHX,20,55,55,8,8,126
1333,American,JFK,PHX,11,19,18,10,7,54
1334,United,ATL,SEA,11,5,57,5,0,67
1335,United,JFK,BOS,4,30,10,2,14,56
1336,American,LAX,SEA,1,8,5,0,6,19
1337,Southwest,ORD,PHX,15,12,13,0,11,36
1338,United,ORD,DEN,19,9,37,4,28,78
1339,Delta,DFW,DEN,23,20,30,6,4,60
1340,JetBlue,ORD,PHX,3,55,43,8,18,124
1341,United,ORD,BOS,10,39,23,1,13,76
1342,Delta,ATL,MIA,10,48,24,14,10,96
1343,JetBlue,JFK,MIA,16,59,16,3,14,92
1344,American,ATL,MIA,6,51,59,14,24,148
1345,Delta,ATL,PHX,15,11,46,11,17,85
1346,Delta,JFK,BOS,13,27,28,8,22,85
1347,American,ATL,PHX,19,30,36,8,5,79
1348,JetBlue,ORD,SEA,12,46,43,14,20,123
1349,American,ATL,SEA,19,8,53,11,8,80
1350,Southwest,LAX,DEN,20,6,18,4,4,32
1351,JetBlue,DFW,BOS,22,2,11,8,16,37
1352,Southwest,LAX,SEA,0,52,49,12,19,132
1353,Southwest,DFW,DEN,20,8,43,3,11,65
1354,Southwest,DFW,PHX,18,30,27,11,3,71
1355,Southwest,LAX,PHX,19,19,50,8,2,79
1356,Southwest,JFK,DEN,20,18,51,12,11,92
1357,United,LAX,MIA,2,42,26,12,4,84
1358,American,DFW,PHX,22,9,42,12,14,77
1359,American,ORD,PHX,11,10,0,14,8,32
1360,JetBlue,LAX,SEA,7,20,24,4,1,49
1361,Delta,JFK,BOS,1,44,26,14,0,84
1362,Southwest,ATL,SEA,9,56,4,11,7,78
1363,American,JFK,MIA,0,28,13,7,29,77
1364,American,ORD,DEN,20,55,4,4,17,80
1365,United,ORD,SEA,22,8,6,10,9,33
1366,Delta,ATL,SEA,2,43,3,10,25,81
1367,Delta,JFK,BOS,18,56,30,3,6,95
1368,Delta,JFK,PHX,0,10,55,4,9,78
1369,United,LAX,BOS,17,30,4,10,16,60
1370,United,ORD,PHX,23,38,59,14,3,114
1371,Delta,DFW,BOS,17,15,47,3,26,91
1372,Southwest,LAX,SEA,16,5,20,11,16,52
1373,United,JFK,BOS,18,55,19,1,14,89
1374,Southwest,ORD,PHX,12,58,27,8,17,110
1375,American,ATL,DEN,5,27,48,7,1,83
1376,United,LAX,MIA,17,13,34,14,13,74
1377,United,ATL,SEA,17,9,1,6,28,44
1378,Southwest,ATL,SEA,17,40,6,3,28,77
1379,Southwest,ORD,BOS,19,42,22,6,22,92
1380,JetBlue,JFK,DEN,14,44,44,6,16,110
1381,Southwest,ATL,DEN,21,48,54,12,9,123
1382,American,LAX,DEN,15,11,30,0,17,58
1383,JetBlue,JFK,MIA,7,52,33,9,15,109
1384,Southwest,JFK,PHX,11,58,9,5,4,76
1385,Southwest,ATL,SEA,21,31,26,2,0,59
1386,JetBlue,ORD,SEA,22,49,47,6,0,102
1387,JetBlue,ATL,BOS,6,47,59,3,27,136
1388,JetBlue,ATL,SEA,12,11,35,10,27,83
1389,American,DFW,MIA,21,12,51,1,24,88
1390,Southwest,ATL,SEA,13,11,14,2,24,51
1391,American,ORD,MIA,18,48,11,13,13,85
1392,United,ORD,DEN,3,39,40,4,11,94
1393,United,ORD,SEA,23,43,31,14,15,103
1394,JetBlue,DFW,SEA,2,37,7,3,4,51
1395,JetBlue,JFK,PHX,1,36,29,9,28,102
1396,Delta,JFK,SEA,17,32,3,1,16,52
1397,United,JFK,SEA,17,38,13,11,3,65
1398,Delta,JFK,MIA,18,56,56,11,2,125
1399,JetBlue,ATL,PHX,12,12,21,12,24,69
1400,Southwest,DFW,BOS,12,41,6,8,3,58
1401,Delta,LAX,PHX,1,32,5,0,20,57
1402,JetBlue,DFW,MIA,16,6,20,9,3,38
1403,American,JFK,MIA,11,6,23,10,25,64
1404,United,ORD,PHX,5,50,16,9,25,100
1405,Southwest,ORD,MIA,18,43,18,1,1,63
1406,Delta,DFW,BOS,3,57,16,8,28,109
1407,American,ATL,SEA,19,56,13,14,5,88
1408,Southwest,ORD,DEN,15,15,8,5,14,42
1409,Delta,ATL,PHX,17,6,55,11,24,96
1410,United,DFW,MIA,12,56,18,6,13,93
1411,United,ATL,DEN,17,16,18,13,19,66
1412,American,ATL,SEA,19,23,9,12,10,54
1413,JetBlue,ATL,MIA,20,17,2,9,13,41
1414,Delta,JFK,SEA,5,24,37,12,22,95
1415,United,ATL,PHX,9,19,48,0,22,89
1416,Southwest,LAX,BOS,10,59,33,1,3,96
1417,United,ATL,PHX,13,56,54,0,11,121
1418,United,DFW,SEA,12,38,5,10,18,71
1419,United,JFK,SEA,22,12,33,1,21,67
1420,Delta,ORD,DEN,14,12,44,4,2,62
1421,Delta,JFK,MIA,8,18,6,6,27,57
1422,Delta,ATL,SEA,4,38,13,7,15,73
1423,Southwest,ORD,DEN,12,31,21,10,25,87
1424,JetBlue,ORD,PHX,10,16,59,14,10,99
1425,American,ATL,BOS,1,28,40,14,15,97
1426,United,LAX,SEA,6,47,5,11,21,84
1427,United,ATL,MIA,15,9,18,8,3,38
1428,JetBlue,JFK,BOS,2,50,6,9,10,75
1429,JetBlue,DFW,PHX,23,46,42,9,7,104
1430,American,ORD,BOS,14,50,31,6,11,98
1431,American,ATL,PHX,11,30,27,3,3,63
1432,JetBlue,ORD,PHX,8,21,32,11,28,92
1433,United,ORD,SEA,21,21,16,7,5,49
1434,Delta,JFK,DEN,10,20,12,0,10,42
1435,JetBlue,JFK,SEA,19,36,26,1,20,83
1436,JetBlue,JFK,DEN,23,12,15,7,15,49
1437,United,ATL,DEN,8,0,51,3,2,56
1438,Delta,LAX,MIA,3,46,38,4,4,92
1439,Delta,DFW,PHX,9,5,38,8,13,64
1440,Delta,LAX,DEN,4,14,9,0,20,43
1441,JetBlue,JFK,PHX,20,47,48,1,19,115
1442,United,ATL,BOS,5,9,29,6,28,72
1443,Delta,JFK,PHX,23,1,30,2,11,44
1444,United,ATL,MIA,8,27,14,9,29,79
1445,American,DFW,BOS,6,58,27,12,27,124
1446,Delta,ATL,MIA,8,16,9,9,3,37
1447,JetBlue,ATL,BOS,5,27,11,8,4,50
1448,United,LAX,DEN,20,47,30,1,4,82
1449,Delta,LAX,BOS,17,47,18,9,21,95
1450,Southwest,JFK,MIA,10,50,12,13,20,95
1451,Southwest,ATL,DEN,16,26,11,13,11,61
1452,United,ORD,SEA,2,8,24,8,8,48
1453,Southwest,ATL,PHX,19,44,3,10,6,63
1454,United,DFW,BOS,8,34,38,8,28,108
1455,American,JFK,MIA,10,8,18,2,7,35
1456,JetBlue,ORD,BOS,14,1,5,1,26,33
1457,Delta,ATL,BOS,17,1,46,12,10,69
1458,JetBlue,JFK,DEN,6,50,51,2,8,111
1459,Southwest,JFK,SEA,13,36,53,5,26,120
1460,JetBlue,ATL,DEN,23,54,23,14,26,117
1461,American,JFK,DEN,18,8,53,5,7,73
1462,Southwest,JFK,PHX,19,20,22,5,19,66
1463,United,JFK,DEN,0,40,59,2,21,122
1464,Delta,ORD,MIA,22,20,54,5,7,86
1465,Southwest,ORD,DEN,20,0,29,9,0,38
1466,Delta,JFK,DEN,5,39,10,2,27,78
1467,United,ORD,BOS,6,15,5,5,20,45
1468,American,JFK,BOS,12,16,52,6,6,80
1469,Delta,DFW,MIA,17,14,31,14,29,88
1470,United,JFK,SEA,20,30,27,8,27,92
1471,Delta,LAX,MIA,15,42,31,10,7,90
1472,JetBlue,DFW,DEN,14,54,4,14,24,96
1473,American,ORD,PHX,1,42,33,4,6,85
1474,JetBlue,LAX,MIA,4,11,12,7,22,52
1475,JetBlue,ORD,BOS,1,9,38,2,9,58
1476,United,DFW,DEN,21,53,4,13,27,97
1477,Southwest,JFK,SEA,6,13,55,1,2,71
1478,American,ATL,BOS,12,6,18,8,12,44
1479,JetBlue,LAX,BOS,1,16,50,10,6,82
1480,Delta,ORD,BOS,19,16,28,6,12,62
1481,American,ORD,DEN,10,17,10,9,7,43
1482,JetBlue,JFK,BOS,1,56,32,11,16,115
1483,JetBlue,ATL,DEN,15,27,30,12,29,98
1484,Delta,ATL,SEA,8,47,4,3,17,71
1485,JetBlue,JFK,DEN,21,22,45,10,3,80
1486,Delta,ORD,PHX,1,38,6,9,5,58
1487,American,ORD,DEN,14,32,20,0,1,53
1488,JetBlue,LAX,MIA,14,32,13,8,16,69
1489,United,DFW,BOS,6,3,29,0,12,44
1490,American,ORD,BOS,6,24,47,12,15,98
1491,Delta,ORD,SEA,20,19,55,11,25,110
1492,Delta,JFK,MIA,17,44,23,7,24,98
1493,Southwest,ORD,SEA,12,38,50,6,4,98
1494,American,ATL,DEN,9,37,20,8,26,91
1495,United,ORD,DEN,9,52,53,8,15,128
1496,American,DFW,DEN,4,30,2,9,28,69
1497,United,DFW,BOS,18,24,38,4,27,93
1498,JetBlue,ORD,BOS,11,59,23,4,23,109
1499,Southwest,DFW,PHX,8,14,41,8,5,68
1500,Delta,ATL,MIA,20,43,29,9,22,103
1501,JetBlue,JFK,BOS,9,30,54,12,20,116
1502,JetBlue,JFK,DEN,22,33,38,11,27,109
1503,Delta,ATL,SEA,17,3,58,10,2,73
1504,American,DFW,BOS,5,26,44,0,22,92
1505,Southwest,ORD,PHX,23,1,29,12,14,56
1506,JetBlue,LAX,PHX,15,13,20,8,16,57
1507,Southwest,LAX,BOS,1,4,9,2,18,33
1508,Southwest,JFK,DEN,7,35,1,4,26,66
1509,United,JFK,MIA,21,40,34,12,0,86
1510,United,DFW,SEA,10,15,27,1,20,63
1511,American,ORD,PHX,13,53,14,10,10,87
1512,American,DFW,PHX,19,15,17,2,5,39
1513,American,ORD,BOS,12,1,8,11,19,39
1514,Delta,ATL,DEN,19,19,36,9,16,80
1515,JetBlue,JFK,MIA,0,0,58,6,28,92
1516,Southwest,DFW,BOS,2,53,2,3,6,64
1517,Southwest,DFW,BOS,14,26,57,6,2,91
1518,JetBlue,LAX,DEN,13,33,19,9,15,76
1519,United,LAX,BOS,11,39,47,12,18,116
1520,United,DFW,PHX,20,37,22,3,6,68
1521,Southwest,DFW,DEN,8,31,54,11,28,124
1522,United,DFW,DEN,3,55,43,9,20,127
1523,Delta,LAX,MIA,21,49,8,10,12,79
1524,JetBlue,ORD,DEN,9,16,38,0,8,62
1525,United,ATL,PHX,1,9,4,12,25,50
1526,Southwest,DFW,DEN,1,2,40,2,18,62
1527,United,ATL,DEN,15,52,20,4,17,93
1528,American,ATL,MIA,16,56,18,13,29,116
1529,United,ORD,MIA,13,5,27,5,27,64
1530,Delta,LAX,DEN,3,46,1,6,3,56
1531,JetBlue,ATL,SEA,16,4,37,0,29,70
1532,JetBlue,DFW,SEA,9,55,47,4,11,117
1533,JetBlue,ATL,DEN,7,11,35,5,12,63
1534,American,ORD,SEA,20,40,7,9,24,80
1535,United,JFK,DEN,0,19,59,11,4,93
1536,Delta,ATL,PHX,20,54,42,3,14,113
1537,Southwest,ATL,PHX,20,5,24,14,19,62
1538,Southwest,JFK,SEA,22,5,11,13,28,57
1539,JetBlue,LAX,DEN,2,14,11,7,18,50
1540,American,DFW,PHX,2,49,4,3,2,58
1541,United,LAX,BOS,15,46,44,11,15,116
1542,Southwest,ORD,BOS,6,58,21,14,21,114
1543,United,JFK,BOS,0,6,0,10,17,33
1544,Delta,LAX,BOS,3,33,26,8,19,86
1545,American,DFW,PHX,21,18,40,7,20,85
1546,American,JFK,SEA,19,26,58,0,17,101
1547,JetBlue,ATL,SEA,11,38,35,9,8,90
1548,American,JFK,BOS,19,9,59,11,4,83
1549,Delta,LAX,BOS,14,3,53,10,3,69
1550,United,JFK,SEA,7,18,50,5,3,76
1551,Southwest,ORD,PHX,4,8,21,6,27,62
1552,JetBlue,ORD,MIA,12,20,45,12,8,85
1553,Delta,ATL,DEN,13,1,24,0,8,33
1554,Delta,DFW,PHX,17,44,10,12,21,87
1555,Southwest,ORD,PHX,6,9,40,1,0,50
1556,United,ATL,PHX,20,59,19,6,16,100
1557,United,LAX,BOS,20,1,21,11,2,35
1558,Delta,DFW,PHX,6,42,13,4,15,74
1559,United,JFK,BOS,19,49,50,2,3,104
1560,American,DFW,PHX,7,52,24,1,20,97
1561,JetBlue,JFK,PHX,8,4,53,8,5,70
1562,Southwest,DFW,PHX,7,23,18,1,0,42
1563,United,ATL,PHX,4,31,11,6,2,50
1564,Delta,ATL,MIA,14,32,3,8,16,59
1565,Southwest,LAX,PHX,18,32,24,3,26,85
1566,United,LAX,PHX,18,35,48,14,9,106
1567,Delta,DFW,PHX,3,6,23,4,29,62
1568,American,LAX,DEN,0,26,28,12,10,76
1569,United,JFK,DEN,7,2,59,4,5,70
1570,American,ORD,MIA,17,42,51,13,29,135
1571,American,DFW,PHX,16,23,47,4,6,80
1572,JetBlue,LAX,MIA,11,55,16,4,24,99
1573,JetBlue,LAX,MIA,9,1,6,3,22,32
1574,American,LAX,DEN,16,14,49,4,2,69
1575,Southwest,JFK,PHX,4,29,14,10,21,74
1576,American,ORD,PHX,13,3,25,2,0,30
1577,United,ORD,MIA,11,51,41,4,27,123
1578,Delta,LAX,SEA,7,25,9,13,9,56
1579,Delta,JFK,MIA,8,21,54,9,12,96
1580,JetBlue,ORD,BOS,23,3,19,4,24,50
1581,JetBlue,LAX,PHX,1,21,57,7,15,100
1582,United,JFK,BOS,10,0,6,0,24,30
1583,Delta,ATL,BOS,21,51,0,10,3,64
1584,Delta,LAX,MIA,6,30,52,9,25,116
1585,JetBlue,DFW,BOS,9,3,16,10,19,48
1586,JetBlue,DFW,SEA,10,2,39,9,10,60
1587,United,ORD,BOS,20,10,24,2,6,42
1588,United,ATL,PHX,18,11,8,7,21,47
1589,Delta,DFW,SEA,7,59,3,8,20,90
1590,JetBlue,JFK,BOS,0,26,56,2,1,85
1591,American,ORD,BOS,1,46,37,4,23,110
1592,JetBlue,JFK,MIA,16,3,19,0,25,47
1593,Delta,ORD,BOS,11,0,50,12,20,82
1594,Southwest,JFK,PHX,10,31,10,10,13,64
1595,American,ORD,MIA,4,0,22,9,20,51
1596,American,LAX,MIA,6,48,52,2,22,124
1597,JetBlue,LAX,PHX,5,37,7,12,15,71
1598,Delta,DFW,SEA,22,48,58,9,11,126
1599,United,DFW,SEA,14,30,42,6,14,92
1600,United,ORD,MIA,8,37,56,7,23,123
1601,Delta,ORD,DEN,5,22,14,0,21,57
1602,Delta,LAX,SEA,19,0,36,12,4,52
1603,JetBlue,ORD,MIA,6,16,29,10,18,73
1604,Delta,JFK,SEA,21,5,41,4,27,77
1605,United,LAX,PHX,6,48,52,5,19,124
1606,JetBlue,ORD,PHX,10,41,41,13,25,120
1607,United,LAX,MIA,21,53,16,0,2,71
1608,Delta,JFK,BOS,3,24,22,13,27,86
1609,United,ATL,DEN,9,57,18,0,12,87
1610,JetBlue,LAX,DEN,22,36,29,2,10,77
1611,United,ATL,MIA,8,6,46,10,16,78
1612,JetBlue,ATL,DEN,11,54,40,10,28,132
1613,Southwest,JFK,PHX,5,18,40,11,8,77
1614,American,LAX,MIA,8,53,41,8,20,122
1615,United,JFK,SEA,8,35,4,3,13,55
1616,Southwest,LAX,PHX,15,36,59,8,0,103
1617,Southwest,DFW,PHX,0,8,9,7,25,49
1618,Delta,JFK,SEA,17,6,25,3,7,41
1619,American,LAX,DEN,8,54,41,6,0,101
1620,American,LAX,MIA,19,27,45,11,19,102
1621,JetBlue,LAX,BOS,20,11,45,1,25,82
1622,United,DFW,PHX,16,48,49,0,11,108
1623,American,DFW,BOS,12,48,29,1,26,104
1624,JetBlue,ORD,DEN,8,29,44,0,26,99
1625,JetBlue,ATL,PHX,4,38,18,14,13,83
1626,United,ORD,DEN,17,25,21,2,2,50
1627,Southwest,ATL,BOS,13,52,14,13,20,99
1628,Delta,LAX,DEN,19,2,32,2,25,61
1629,Southwest,DFW,PHX,3,1,21,1,25,48
1630,Southwest,ATL,DEN,22,7,25,4,27,63
1631,Delta,DFW,MIA,23,1,40,1,10,52
1632,Southwest,LAX,MIA,10,7,59,10,17,93
1633,JetBlue,ATL,BOS,6,39,3,12,9,63
1634,United,LAX,SEA,15,43,7,6,15,71
1635,Southwest,LAX,MIA,20,26,33,1,10,70
1636,JetBlue,JFK,PHX,16,23,49,13,1,86
1637,United,LAX,PHX,1,43,58,5,22,128
1638,JetBlue,DFW,MIA,16,14,17,1,23,55
1639,American,LAX,PHX,2,8,0,6,15,29
1640,Southwest,LAX,DEN,17,37,15,3,8,63
1641,American,LAX,BOS,20,5,15,4,12,36
1642,JetBlue,DFW,SEA,2,21,48,10,14,93
1643,JetBlue,DFW,PHX,20,35,59,6,10,110
1644,American,ORD,BOS,1,53,20,13,2,88
1645,Delta,LAX,PHX,0,27,42,2,29,100
1646,Southwest,ORD,SEA,9,43,23,11,18,95
1647,JetBlue,ATL,DEN,5,20,38,3,26,87
1648,American,ORD,MIA,16,36,38,0,2,76
1649,JetBlue,DFW,SEA,5,39,18,13,11,81
1650,JetBlue,DFW,BOS,7,28,18,10,15,71
1651,Southwest,ATL,MIA,5,18,10,13,18,59
1652,United,DFW,PHX,0,1,48,6,11,66
1653,Southwest,ATL,PHX,3,41,50,6,3,100
1654,United,ORD,PHX,16,24,54,5,0,83
1655,Delta,DFW,BOS,3,25,10,5,4,44
1656,Delta,JFK,SEA,12,32,35,3,1,71
1657,Southwest,ORD,BOS,22,44,17,7,0,68
1658,Southwest,DFW,BOS,21,38,22,5,7,72
1659,Delta,LAX,DEN,21,1,31,9,2,43
1660,JetBlue,LAX,BOS,18,53,20,14,22,109
1661,Southwest,ATL,PHX,10,46,15,1,8,70
1662,Southwest,JFK,DEN,7,35,42,4,19,100
1663,Southwest,ORD,BOS,18,25,29,5,22,81
1664,Delta,DFW,PHX,2,39,19,6,12,76
1665,American,DFW,PHX,12,0,24,7,8,39
1666,JetBlue,JFK,PHX,21,44,44,2,16,106
1667,JetBlue,ATL,PHX,1,22,47,9,3,81
1668,JetBlue,DFW,PHX,14,7,51,2,18,78
1669,Southwest,ATL,DEN,22,20,42,5,11,78
1670,Delta,LAX,PHX,14,15,11,14,1,41
1671,United,DFW,PHX,9,42,53,11,17,123
1672,American,JFK,PHX,19,15,13,7,20,55
1673,American,DFW,BOS,20,5,47,0,13,65
1674,Southwest,LAX,DEN,6,34,11,13,17,75
1675,Southwest,ATL,BOS,2,18,46,0,12,76
1676,Southwest,JFK,MIA,14,35,15,8,15,73
1677,Delta,LAX,DEN,12,18,42,14,6,80
1678,Delta,ATL,MIA,10,11,17,0,19,47
1679,United,LAX,SEA,22,23,15,13,21,72
1680,American,ATL,DEN,23,5,45,2,11,63
1681,American,ORD,BOS,5,1,52,10,12,75
1682,United,LAX,MIA,14,51,17,10,24,102
1683,United,ATL,DEN,20,37,22,2,22,83
1684,United,JFK,SEA,23,4,7,14,20,45
1685,Delta,ATL,PHX,0,29,40,5,2,76
1686,American,DFW,PHX,15,49,19,0,14,82
1687,JetBlue,DFW,MIA,8,21,14,6,19,60
1688,United,ATL,MIA,21,58,29,8,27,122
1689,JetBlue,LAX,DEN,8,25,20,8,15,68
1690,Delta,LAX,DEN,9,10,34,2,4,50
1691,American,LAX,DEN,17,59,57,4,10,130
1692,JetBlue,ATL,SEA,5,19,12,1,2,34
1693,United,JFK,BOS,20,57,47,13,4,121
1694,JetBlue,ATL,MIA,21,1,18,10,17,46
1695,United,ATL,SEA,3,8,6,10,28,52
1696,JetBlue,ORD,BOS,19,11,50,5,27,93
1697,JetBlue,JFK,MIA,20,23,3,0,11,37
1698,United,ORD,MIA,23,11,58,11,26,106
1699,United,ORD,BOS,2,35,13,10,15,73
1700,Southwest,JFK,BOS,17,36,13,11,20,80
1701,Delta,LAX,BOS,14,24,19,4,15,62
1702,American,DFW,SEA,7,3,36,8,23,70
1703,American,ATL,DEN,14,47,13,2,23,85
1704,JetBlue,DFW,PHX,19,22,25,7,5,59
1705,Delta,LAX,SEA,12,46,45,7,5,103
1706,JetBlue,ORD,MIA,5,18,51,12,23,104
1707,United,DFW,PHX,4,24,14,1,21,60
1708,Delta,ORD,MIA,13,38,23,10,16,87
1709,JetBlue,JFK,BOS,3,8,30,6,11,55
1710,Delta,JFK,MIA,3,15,27,4,2,48
1711,Delta,ATL,DEN,18,54,42,7,15,118
1712,Delta,ATL,MIA,1,4,11,9,2,26
1713,JetBlue,LAX,DEN,4,21,47,5,7,80
1714,Delta,DFW,DEN,9,43,43,4,29,119
1715,Delta,LAX,PHX,18,13,21,7,2,43
1716,American,DFW,BOS,22,19,20,14,18,71
1717,Southwest,JFK,PHX,4,3,33,14,23,73
1718,Delta,ATL,SEA,10,44,15,0,26,85
1719,Southwest,ORD,BOS,5,58,1,6,8,73
1720,JetBlue,ATL,DEN,15,28,45,3,21,97
1721,JetBlue,DFW,BOS,0,54,17,2,0,73
1722,JetBlue,DFW,BOS,20,11,30,5,16,62
1723,Southwest,ATL,PHX,13,50,13,10,1,74
1724,American,ORD,SEA,4,21,19,6,6,52
1725,United,DFW,SEA,6,38,12,0,16,66
1726,JetBlue,ORD,PHX,5,39,52,11,17,119
1727,American,DFW,MIA,22,8,58,2,11,79
1728,American,DFW,SEA,16,20,22,7,6,55
1729,Delta,ATL,DEN,6,27,4,6,28,65
1730,Delta,JFK,SEA,17,44,11,8,16,79
1731,Southwest,ATL,DEN,10,45,31,14,13,103
1732,American,LAX,DEN,3,52,37,4,10,103
1733,Southwest,JFK,MIA,4,50,30,1,2,83
1734,JetBlue,ORD,MIA,11,59,54,9,5,127
1735,American,LAX,PHX,1,6,31,1,3,41
1736,American,JFK,DEN,16,10,35,12,11,68
1737,United,LAX,MIA,9,25,40,9,22,96
1738,Southwest,ATL,SEA,14,17,21,10,21,69
1739,United,JFK,PHX,22,9,58,10,13,90
1740,Delta,LAX,BOS,10,5,21,12,12,50
1741,United,DFW,DEN,10,57,4,12,25,98
1742,JetBlue,ATL,DEN,22,46,37,11,22,116
1743,American,ORD,MIA,8,24,54,13,20,111
1744,JetBlue,ATL,PHX,3,41,18,13,29,101
1745,Delta,JFK,BOS,4,33,29,8,17,87
1746,United,ATL,SEA,2,14,2,14,4,34
1747,JetBlue,LAX,BOS,13,5,54,8,11,78
1748,United,JFK,PHX,8,47,55,3,25,130
1749,United,DFW,PHX,19,59,45,12,2,118
1750,Delta,ATL,MIA,20,32,4,9,28,73
1751,United,ATL,SEA,15,59,23,3,0,85
1752,JetBlue,LAX,BOS,4,50,6,1,13,70
1753,JetBlue,LAX,MIA,13,8,20,5,15,48
1754,United,JFK,SEA,17,8,36,10,12,66
1755,United,JFK,BOS,22,53,8,8,25,94
1756,American,ATL,SEA,21,0,39,4,7,50
1757,United,ORD,SEA,17,44,45,0,26,115
1758,American,ORD,SEA,1,56,38,2,3,99
1759,JetBlue,DFW,MIA,3,16,48,6,11,81
1760,Southwest,ATL,PHX,6,21,18,7,20,66
1761,United,LAX,BOS,1,2,56,0,20,78
1762,American,LAX,MIA,6,54,42,12,16,124
1763,American,DFW,DEN,12,50,37,0,26,113
1764,Southwest,JFK,BOS,3,8,44,5,8,65
1765,JetBlue,ATL,BOS,8,23,33,0,23,79
1766,American,LAX,PHX,20,59,22,12,15,108
1767,Southwest,ATL,PHX,17,7,38,2,22,69
1768,Southwest,DFW,MIA,6,9,36,12,8,65
1769,Delta,JFK,DEN,0,34,24,2,23,83
1770,Delta,ATL,SEA,7,54,9,9,7,79
1771,Delta,JFK,DEN,1,14,26,10,11,61
1772,Delta,ORD,BOS,23,49,32,11,8,100
1773,Delta,ATL,BOS,16,49,6,5,22,82
1774,American,ORD,BOS,17,18,3,11,2,34
1775,Delta,ORD,BOS,9,30,9,14,1,54
1776,American,DFW,MIA,0,42,5,14,26,87
1777,United,DFW,DEN,20,22,21,14,6,63
1778,American,LAX,PHX,16,30,32,1,11,74
1779,Delta,JFK,DEN,22,2,17,9,6,34
1780,Southwest,LAX,MIA,17,15,22,3,24,64
1781,Delta,LAX,BOS,2,41,12,13,3,69
1782,Delta,JFK,PHX,15,10,29,3,17,59
1783,American,DFW,SEA,5,47,13,11,5,76
1784,JetBlue,JFK,DEN,0,10,4,8,2,24
1785,Southwest,LAX,DEN,10,9,30,1,4,44
1786,JetBlue,LAX,MIA,23,29,59,8,25,121
1787,Southwest,DFW,PHX,13,38,53,11,22,124
1788,Delta,DFW,BOS,9,18,47,3,14,82
1789,United,ORD,DEN,3,53,49,4,4,110
1790,Southwest,ORD,MIA,23,58,19,10,7,94
1791,Southwest,ATL,PHX,7,40,3,10,9,62
1792,American,LAX,DEN,13,13,3,4,0,20
1793,United,ATL,DEN,1,52,54,7,5,118
1794,United,JFK,BOS,6,17,19,10,19,65
1795,United,ORD,SEA,23,31,45,2,22,100
1796,JetBlue,ATL,PHX,11,0,23,7,14,44
1797,JetBlue,JFK,SEA,14,31,35,10,12,88
1798,JetBlue,JFK,PHX,23,57,27,11,28,123
1799,Delta,ORD,MIA,5,35,17,10,9,71
1800,Delta,ORD,SEA,15,22,32,12,19,85
1801,Southwest,LAX,MIA,17,35,18,2,9,64
1802,Delta,DFW,BOS,21,43,30,10,20,103
1803,American,JFK,BOS,4,44,36,2,24,106
1804,Southwest,DFW,BOS,23,54,42,6,22,124
1805,American,JFK,SEA,1,45,22,9,16,92
1806,JetBlue,DFW,MIA,22,51,36,5,21,113
1807,Southwest,ORD,DEN,5,4,1,2,3,10
1808,JetBlue,LAX,SEA,4,9,45,1,13,68
1809,Southwest,ORD,DEN,19,18,1,9,26,54
1810,United,JFK,SEA,15,7,33,0,8,48
1811,JetBlue,JFK,DEN,15,22,6,2,14,44
1812,Southwest,DFW,PHX,16,35,3,4,10,52
1813,Southwest,ORD,MIA,1,58,58,14,9,139
1814,American,ORD,BOS,22,17,42,7,3,69
1815,Southwest,ATL,DEN,2,10,51,4,10,75
1816,Delta,LAX,BOS,20,45,8,7,1,61
1817,Southwest,JFK,MIA,4,18,0,1,2,21
1818,American,DFW,DEN,18,30,19,4,23,76
1819,United,JFK,BOS,11,33,52,5,16,106
1820,Delta,JFK,PHX,9,37,36,11,13,97
1821,American,ORD,MIA,16,30,43,13,10,96
1822,American,LAX,MIA,11,52,31,13,22,118
1823,American,ATL,PHX,20,55,39,8,1,103
1824,Southwest,ORD,SEA,1,14,24,8,0,46
1825,Southwest,ORD,SEA,10,30,0,2,26,58
1826,United,ORD,BOS,11,45,32,9,22,108
1827,Southwest,LAX,PHX,12,41,6,8,20,75
1828,Delta,ORD,PHX,1,55,33,4,14,106
1829,Delta,LAX,DEN,13,14,32,5,24,75
1830,American,ORD,PHX,16,18,25,11,27,81
1831,Delta,ORD,BOS,18,59,47,7,27,140
1832,Southwest,LAX,SEA,21,0,53,0,14,67
1833,United,JFK,BOS,15,44,25,7,26,102
1834,United,LAX,DEN,7,4,14,8,11,37
1835,American,JFK,DEN,19,33,24,12,14,83
1836,United,ORD,MIA,6,58,45,6,5,114
1837,Delta,JFK,DEN,18,47,42,3,2,94
1838,United,LAX,BOS,5,49,30,14,26,119
1839,JetBlue,JFK,MIA,0,38,23,13,26,100
1840,Southwest,ATL,SEA,8,24,23,8,15,70
1841,JetBlue,ORD,PHX,7,8,39,4,10,61
1842,United,ORD,DEN,13,8,7,11,3,29
1843,Southwest,LAX,SEA,18,20,14,8,27,69
1844,American,JFK,DEN,5,34,7,0,17,58
1845,Delta,ORD,DEN,22,46,18,14,2,80
1846,JetBlue,ORD,SEA,2,34,32,11,8,85
1847,United,ORD,BOS,22,1,38,10,27,76
1848,Delta,ATL,SEA,22,58,48,12,2,120
1849,Southwest,ATL,BOS,11,7,10,11,9,37
1850,United,ATL,PHX,14,4,57,7,18,86
1851,American,DFW,MIA,9,28,21,4,29,82
1852,United,ORD,BOS,14,21,32,2,19,74
1853,JetBlue,JFK,MIA,10,53,59,10,15,137
1854,JetBlue,LAX,MIA,15,42,48,1,25,116
1855,American,ATL,PHX,8,39,30,13,15,97
1856,JetBlue,ATL,SEA,20,35,10,4,17,66
1857,Delta,ATL,SEA,22,49,49,13,0,111
1858,JetBlue,DFW,MIA,0,23,40,12,17,92
1859,United,JFK,MIA,19,43,29,10,7,89
1860,American,JFK,PHX,15,44,9,4,9,66
1861,United,ATL,BOS,20,30,16,14,15,75
1862,American,DFW,DEN,14,58,9,1,0,68
1863,United,ATL,DEN,9,29,40,5,7,81
1864,JetBlue,DFW,SEA,17,28,21,7,4,60
1865,Delta,ORD,DEN,11,6,16,9,4,35
1866,JetBlue,DFW,PHX,20,58,11,0,0,69
1867,JetBlue,LAX,MIA,19,21,14,10,24,69
1868,United,ORD,BOS,22,33,55,1,21,110
1869,Southwest,ORD,PHX,13,14,42,3,5,64
1870,American,ORD,DEN,3,41,8,7,6,62
1871,United,ATL,SEA,8,1,17,11,23,52
1872,Delta,DFW,SEA,8,20,37,11,22,90
1873,American,ATL,PHX,7,49,39,2,22,112
1874,United,LAX,DEN,0,31,48,4,0,83
1875,Southwest,ATL,BOS,16,2,14,13,28,57
1876,United,DFW,BOS,9,7,38,0,12,57
1877,American,ATL,BOS,18,49,22,8,28,107
1878,United,JFK,SEA,19,25,15,12,29,81
1879,Southwest,LAX,PHX,10,47,54,6,25,132
1880,JetBlue,ORD,MIA,10,34,10,9,12,65
1881,American,ORD,BOS,15,29,33,11,6,79
1882,American,DFW,PHX,5,2,28,1,1,32
1883,Delta,DFW,MIA,6,39,42,1,14,96
1884,Southwest,JFK,DEN,17,1,41,3,8,53
1885,United,JFK,BOS,15,52,31,9,25,117
1886,Southwest,DFW,BOS,23,0,35,9,0,44
1887,Southwest,ORD,PHX,10,5,7,0,8,20
1888,Delta,JFK,MIA,1,41,58,7,15,121
1889,JetBlue,ATL,MIA,4,36,32,5,13,86
1890,JetBlue,ATL,BOS,16,43,10,14,3,70
1891,United,JFK,DEN,18,51,9,11,12,83
1892,United,ATL,PHX,5,47,34,10,21,112
1893,Delta,JFK,PHX,4,56,13,10,3,82
1894,JetBlue,DFW,MIA,3,40,55,13,15,123
1895,Southwest,DFW,MIA,11,1,18,7,22,48
1896,JetBlue,ATL,BOS,2,50,14,14,22,100
1897,American,ATL,MIA,13,23,1,10,13,47
1898,Delta,ATL,BOS,4,56,0,4,7,67
1899,United,JFK,SEA,19,19,22,9,23,73
1900,JetBlue,ORD,PHX,4,9,34,7,21,71
1901,American,JFK,MIA,18,21,27,3,17,68
1902,Southwest,ATL,DEN,12,47,16,14,10,87
1903,United,LAX,DEN,3,2,36,7,16,61
1904,United,JFK,DEN,13,28,21,6,6,61
1905,United,JFK,SEA,11,24,45,2,4,75
1906,Delta,LAX,BOS,13,18,36,0,15,69
1907,JetBlue,LAX,PHX,15,2,3,13,10,28
1908,Southwest,DFW,MIA,18,30,47,5,8,90
1909,American,ORD,MIA,19,16,53,5,9,83
1910,Southwest,LAX,DEN,4,18,36,7,20,81
1911,United,ORD,PHX,20,28,19,9,21,77
1912,JetBlue,ORD,BOS,10,9,4,3,1,17
1913,American,JFK,SEA,23,12,4,12,13,41
1914,JetBlue,ORD,DEN,13,31,53,5,5,94
1915,American,ORD,BOS,17,26,41,5,16,88
1916,United,LAX,DEN,4,8,25,3,9,45
1917,Delta,LAX,DEN,7,48,43,0,20,111
1918,JetBlue,ORD,MIA,0,12,57,10,25,104
1919,Southwest,ORD,BOS,5,25,13,8,25,71
1920,American,ORD,BOS,0,37,32,11,12,92
1921,Delta,LAX,DEN,22,29,23,7,18,77
1922,American,ATL,PHX,14,16,59,4,0,79
1923,United,JFK,MIA,21,26,50,3,27,106
1924,Delta,DFW,SEA,5,59,39,10,7,115
1925,American,DFW,SEA,0,25,10,0,5,40
1926,JetBlue,ATL,MIA,7,26,16,12,2,56
1927,Southwest,DFW,BOS,18,1,0,8,13,22
1928,American,DFW,BOS,20,1,17,13,17,48
1929,Delta,ATL,SEA,7,39,2,0,8,49
1930,American,JFK,MIA,4,6,13,12,17,48
1931,Delta,ORD,SEA,21,39,49,13,11,112
1932,JetBlue,ORD,PHX,17,1,58,4,22,85
1933,Delta,DFW,PHX,23,37,46,10,25,118
1934,Southwest,JFK,SEA,13,4,19,1,16,40
1935,United,LAX,BOS,2,37,32,12,13,94
1936,American,ORD,PHX,8,59,38,1,27,125
1937,Delta,LAX,MIA,8,19,14,3,19,55
1938,United,ATL,PHX,23,3,47,11,18,79
1939,United,ATL,BOS,21,9,28,7,5,49
1940,Delta,JFK,BOS,8,54,51,13,27,145
1941,United,LAX,DEN,2,48,0,6,8,62
1942,Delta,ORD,MIA,12,36,30,10,21,97
1943,United,ATL,PHX,5,7,9,10,0,26
1944,Delta,DFW,MIA,22,7,45,6,6,64
1945,JetBlue,ORD,SEA,23,59,35,4,1,99
1946,Southwest,ATL,BOS,19,21,54,0,16,91
1947,Southwest,JFK,SEA,0,56,18,12,16,102
1948,United,DFW,MIA,0,21,21,3,6,51
1949,Southwest,JFK,DEN,11,45,44,12,22,123
1950,JetBlue,ORD,PHX,7,16,5,2,23,46
1951,JetBlue,JFK,SEA,11,40,20,9,14,83
1952,Southwest,LAX,DEN,23,33,28,10,5,76
1953,Delta,LAX,BOS,0,42,38,6,13,99
1954,American,ATL,SEA,10,59,21,2,7,89
1955,American,ATL,SEA,8,35,24,3,29,91
1956,JetBlue,JFK,DEN,6,5,47,11,5,68
1957,United,JFK,SEA,20,2,35,14,21,72
1958,Southwest,LAX,PHX,19,13,39,0,13,65
1959,American,JFK,PHX,5,32,2,8,9,51
1960,American,ATL,DEN,21,23,31,14,25,93
1961,United,ORD,MIA,1,8,7,4,29,48
1962,United,ATL,DEN,3,20,44,12,7,83
1963,United,DFW,PHX,18,54,43,14,9,120
1964,American,DFW,DEN,0,39,0,8,2,49
1965,American,LAX,PHX,5,52,37,12,8,109
1966,JetBlue,JFK,BOS,19,4,51,8,2,65
1967,American,JFK,BOS,19,38,25,5,13,81
1968,Southwest,JFK,PHX,9,28,21,11,11,71
1969,Delta,ORD,MIA,8,12,42,5,14,73
1970,United,JFK,PHX,4,15,7,4,3,29
1971,JetBlue,ORD,MIA,9,10,13,3,21,47
1972,Southwest,JFK,SEA,21,35,44,1,16,96
1973,JetBlue,ATL,DEN,1,29,43,5,26,103
1974,American,LAX,BOS,8,45,17,3,7,72
1975,Southwest,ORD,MIA,12,29,57,4,4,94
1976,Delta,ORD,PHX,21,22,41,4,13,80
1977,United,ORD,PHX,23,39,6,5,0,50
1978,JetBlue,ORD,DEN,3,54,10,4,28,96
1979,Delta,ATL,PHX,17,35,9,2,3,49
1980,American,DFW,DEN,3,45,32,11,21,109
1981,United,DFW,SEA,2,25,22,13,5,65
1982,American,ORD,DEN,6,28,47,4,2,81
1983,Delta,ORD,MIA,4,19,24,1,18,62
1984,JetBlue,JFK,MIA,6,52,51,1,17,121
1985,United,LAX,DEN,6,49,55,12,10,126
1986,Delta,ATL,PHX,5,28,41,14,25,108
1987,American,ATL,PHX,22,25,27,7,1,60
1988,Southwest,ORD,MIA,19,30,40,12,6,88
1989,Delta,ORD,SEA,16,53,19,0,18,90
1990,United,ATL,BOS,8,21,5,14,16,56
1991,Delta,ATL,PHX,20,31,59,7,24,121
1992,Southwest,LAX,BOS,14,15,18,10,2,45
1993,Delta,LAX,DEN,9,51,58,9,0,118
1994,Southwest,LAX,PHX,16,20,39,4,25,88
1995,JetBlue,JFK,SEA,15,54,56,11,7,128
1996,American,DFW,SEA,2,51,39,2,27,119
1997,Southwest,LAX,DEN,7,20,45,11,6,82
1998,United,ORD,BOS,1,42,43,12,28,125
1999,Southwest,ORD,PHX,8,47,46,11,6,110
2000,American,ATL,SEA,4,37,48,6,18,109
2001,Southwest,ORD,MIA,13,46,15,9,23,93
2002,JetBlue,DFW,MIA,11,20,31,5,16,72
2003,JetBlue,ORD,PHX,14,21,30,13,13,77
2004,Southwest,LAX,BOS,22,38,56,6,9,109
2005,United,DFW,SEA,18,41,8,7,25,81
2006,JetBlue,DFW,MIA,23,30,46,7,12,95
2007,Delta,DFW,MIA,7,1,18,4,24,47
2008,American,JFK,DEN,19,9,53,9,29,100
2009,Southwest,ORD,SEA,22,51,21,11,4,87
2010,United,JFK,BOS,12,16,4,3,16,39
2011,Delta,JFK,MIA,9,47,29,7,21,104
2012,United,LAX,BOS,7,32,24,6,26,88
2013,United,ATL,DEN,3,24,14,12,0,50
2014,United,LAX,BOS,8,34,36,1,22,93
2015,American,JFK,BOS,20,29,45,2,20,96
2016,Delta,ORD,SEA,4,26,37,9,3,75
2017,Delta,LAX,PHX,12,14,23,1,27,65
2018,Delta,JFK,DEN,9,56,34,3,25,118
2019,JetBlue,JFK,BOS,6,58,37,14,9,118
2020,American,LAX,DEN,10,18,30,9,14,71
2021,United,DFW,MIA,19,36,56,0,21,113
2022,United,JFK,DEN,11,32,38,14,28,112
2023,JetBlue,JFK,DEN,10,52,51,7,14,124
2024,United,ORD,BOS,19,9,0,6,11,26
2025,JetBlue,ATL,PHX,14,20,26,5,22,73
2026,United,LAX,BOS,8,17,55,11,24,107
2027,Southwest,ORD,PHX,7,3,25,7,17,52
2028,Southwest,JFK,DEN,1,17,16,4,11,48
2029,American,DFW,SEA,20,26,16,0,10,52
2030,Southwest,ORD,PHX,21,14,55,10,23,102
2031,United,ATL,BOS,19,54,58,9,27,148
2032,United,ORD,MIA,22,28,5,7,8,48
2033,JetBlue,ORD,DEN,21,12,25,9,21,67
2034,JetBlue,ORD,SEA,4,29,48,3,4,84
2035,JetBlue,JFK,DEN,5,30,11,6,11,58
2036,United,DFW,MIA,11,4,43,10,15,72
2037,Delta,JFK,BOS,14,20,10,4,17,51
2038,JetBlue,ATL,MIA,2,33,10,1,19,63
2039,American,JFK,PHX,7,2,36,7,4,49
2040,United,DFW,DEN,2,16,42,6,17,81
2041,American,DFW,SEA,23,35,7,2,15,59
2042,American,DFW,MIA,6,49,34,9,15,107
2043,United,ATL,MIA,1,38,36,9,28,111
2044,Delta,JFK,DEN,12,29,17,6,22,74
2045,Southwest,JFK,BOS,5,41,49,4,21,115
2046,JetBlue,LAX,BOS,12,30,23,10,14,77
2047,United,DFW,DEN,2,26,40,2,7,75
2048,American,ATL,SEA,14,51,22,6,29,108
2049,JetBlue,JFK,MIA,5,15,6,14,21,56
2050,United,JFK,MIA,11,32,57,8,22,119
2051,Southwest,DFW,BOS,22,33,44,2,6,85
2052,American,DFW,BOS,18,8,36,10,2,56
2053,United,LAX,BOS,8,31,10,6,20,67
2054,Delta,ATL,BOS,4,22,31,2,18,73
2055,American,ORD,DEN,15,14,29,3,23,69
2056,Delta,DFW,PHX,10,24,20,11,12,67
2057,JetBlue,LAX,BOS,12,9,28,0,27,64
2058,American,ATL,PHX,14,13,6,10,19,48
2059,United,JFK,SEA,0,17,26,0,27,70
2060,JetBlue,ORD,PHX,20,28,18,11,3,60
2061,Delta,LAX,DEN,16,21,54,11,17,103
2062,Delta,LAX,PHX,19,27,40,13,23,103
2063,United,LAX,BOS,15,31,38,1,23,93
2064,Delta,ORD,BOS,12,16,26,6,10,58
2065,Southwest,ORD,MIA,11,46,22,11,24,103
2066,Delta,LAX,DEN,7,0,10,5,5,20
2067,Delta,ATL,MIA,16,22,24,10,25,81
2068,Delta,ORD,BOS,21,59,57,10,28,154
2069,Southwest,ATL,PHX,14,29,2,8,28,67
2070,American,JFK,PHX,12,15,6,7,18,46
2071,American,ATL,MIA,11,19,36,9,27,91
2072,American,JFK,MIA,14,44,47,5,14,110
2073,Southwest,LAX,SEA,17,44,47,6,11,108
2074,Delta,ATL,MIA,21,15,12,13,16,56
2075,JetBlue,JFK,BOS,0,7,52,7,23,89
2076,Southwest,JFK,MIA,1,50,0,10,5,65
2077,Delta,ORD,BOS,7,34,27,2,13,76
2078,JetBlue,ATL,BOS,8,1,25,12,14,52
2079,JetBlue,ATL,SEA,0,58,56,11,2,127
2080,United,DFW,PHX,1,59,54,0,14,127
2081,United,LAX,PHX,14,17,10,13,22,62
2082,Southwest,ORD,BOS,19,2,23,10,22,57
2083,United,LAX,SEA,0,25,44,9,6,84
2084,United,DFW,DEN,17,3,27,1,22,53
2085,Southwest,DFW,DEN,18,57,19,9,22,107
2086,Southwest,ORD,MIA,17,6,39,12,28,85
2087,Southwest,ATL,DEN,10,54,21,7,28,110
2088,Southwest,DFW,BOS,16,8,1,14,17,40
2089,JetBlue,ORD,MIA,2,13,13,2,18,46
2090,United,ORD,MIA,4,15,52,6,2,75
2091,JetBlue,ORD,MIA,8,10,18,11,23,62
2092,JetBlue,ATL,SEA,15,21,28,7,17,73
2093,JetBlue,JFK,SEA,3,42,50,13,25,130
2094,United,LAX,SEA,1,41,55,3,10,109
2095,United,ATL,SEA,17,7,56,2,23,88
2096,United,LAX,PHX,8,55,12,4,2,73
2097,United,ATL,SEA,9,15,22,9,20,66
2098,JetBlue,ATL,PHX,20,49,0,3,17,69
2099,American,LAX,DEN,19,7,47,0,26,80
2100,American,ATL,DEN,11,50,41,14,25,130
2101,American,DFW,DEN,1,8,8,3,18,37
2102,Southwest,LAX,MIA,17,25,48,7,26,106
2103,American,JFK,PHX,7,44,16,9,29,98
2104,American,LAX,MIA,15,54,17,12,1,84
2105,United,LAX,MIA,17,20,36,8,16,80
2106,United,ORD,PHX,14,4,3,4,3,14
2107,Delta,DFW,PHX,22,44,24,1,18,87
2108,Southwest,ORD,BOS,1,23,23,2,12,60
2109,JetBlue,LAX,MIA,17,1,37,10,28,76
2110,JetBlue,LAX,MIA,12,35,49,3,28,115
2111,Delta,ORD,MIA,0,5,42,0,13,60
2112,JetBlue,DFW,BOS,9,56,43,4,18,121
2113,Delta,ORD,SEA,16,37,33,0,22,92
2114,American,ATL,MIA,14,51,15,0,28,94
2115,Southwest,DFW,MIA,5,43,36,10,4,93
2116,American,ORD,DEN,5,8,48,4,12,72
2117,Southwest,DFW,DEN,9,50,46,4,24,124
2118,Southwest,LAX,SEA,23,30,10,0,24,64
2119,Southwest,ATL,BOS,5,34,20,9,12,75
2120,Delta,ATL,BOS,0,11,33,1,26,71
2121,United,JFK,BOS,12,16,3,8,20,47
2122,United,LAX,BOS,7,14,21,6,0,41
2123,American,LAX,SEA,17,51,38,1,13,103
2124,Delta,ORD,SEA,3,35,11,5,29,80
2125,JetBlue,JFK,PHX,2,4,29,6,4,43
2126,Southwest,DFW,PHX,14,4,44,3,24,75
2127,Delta,ATL,DEN,9,12,46,11,20,89
2128,JetBlue,LAX,PHX,8,34,1,1,25,61
2129,Southwest,DFW,BOS,2,19,32,0,27,78
2130,JetBlue,DFW,DEN,20,46,43,4,8,101
2131,Delta,ATL,MIA,8,3,15,7,18,43
2132,Southwest,ORD,MIA,18,16,3,14,23,56
2133,United,DFW,DEN,20,4,17,7,24,52
2134,American,DFW,SEA,12,0,22,0,2,24
2135,JetBlue,DFW,SEA,3,29,48,0,9,86
2136,American,JFK,BOS,2,37,13,13,14,77
2137,American,JFK,DEN,3,58,1,9,14,82
2138,Southwest,ATL,MIA,4,36,58,7,4,105
2139,JetBlue,DFW,MIA,6,29,6,1,18,54
2140,American,ATL,BOS,15,24,10,4,18,56
2141,Delta,DFW,BOS,1,52,37,6,8,103
2142,JetBlue,DFW,SEA,19,49,21,0,25,95
2143,American,ORD,DEN,3,53,58,3,9,123
2144,United,LAX,SEA,7,57,25,0,14,96
2145,American,DFW,DEN,11,9,0,9,9,27
2146,American,JFK,SEA,0,49,24,13,22,108
2147,Southwest,ORD,DEN,15,49,1,10,15,75
2148,Delta,DFW,BOS,21,47,1,1,28,77
2149,Delta,ORD,MIA,4,32,31,10,11,84
2150,United,ORD,BOS,13,14,18,12,18,62
2151,Delta,DFW,MIA,16,0,42,4,16,62
2152,Delta,LAX,PHX,19,8,40,1,18,67
2153,JetBlue,DFW,PHX,17,28,30,14,28,100
2154,JetBlue,ORD,PHX,12,11,29,3,16,59
2155,Southwest,DFW,PHX,3,36,11,8,13,68
2156,American,DFW,BOS,14,17,55,2,24,98
2157,JetBlue,JFK,SEA,11,53,12,11,23,99
2158,JetBlue,JFK,MIA,7,1,39,2,17,59
2159,United,DFW,BOS,10,24,38,7,17,86
2160,Southwest,JFK,SEA,9,47,9,4,25,85
2161,Delta,JFK,SEA,21,2,42,6,8,58
2162,JetBlue,DFW,DEN,21,34,40,14,5,93
2163,Southwest,ATL,BOS,3,51,7,6,25,89
2164,United,LAX,BOS,14,46,27,10,14,97
2165,United,ATL,BOS,11,23,54,14,24,115
2166,Southwest,ORD,PHX,7,32,49,8,28,117
2167,JetBlue,DFW,SEA,13,9,4,11,21,45
2168,American,ORD,PHX,2,22,17,9,16,64
2169,JetBlue,ORD,BOS,19,8,24,6,1,39
2170,JetBlue,ATL,MIA,16,40,8,3,3,54
2171,Delta,DFW,PHX,13,54,27,1,11,93
2172,JetBlue,JFK,MIA,0,52,58,11,26,147
2173,Delta,DFW,BOS,10,50,43,2,11,106
2174,JetBlue,JFK,DEN,21,49,52,6,1,108
2175,United,ORD,DEN,20,9,41,11,20,81
2176,United,ORD,PHX,0,43,37,3,13,96
2177,Delta,ATL,SEA,8,59,6,3,28,96
2178,United,DFW,SEA,9,55,44,4,27,130
2179,Delta,JFK,SEA,12,16,46,4,17,83
2180,United,JFK,SEA,3,58,55,8,10,131
2181,United,ORD,SEA,11,20,44,7,24,95
2182,United,ATL,PHX,3,47,22,14,7,90
2183,Southwest,DFW,SEA,10,51,3,1,17,72
2184,Southwest,JFK,BOS,17,39,13,1,6,59
2185,Delta,JFK,DEN,0,59,22,14,1,96
2186,Delta,ORD,MIA,6,10,58,14,1,83
2187,Southwest,DFW,PHX,1,36,52,8,27,123
2188,Southwest,ORD,PHX,14,22,11,3,19,55
2189,United,ATL,BOS,15,10,31,9,8,58
2190,JetBlue,ATL,BOS,4,4,40,5,25,74
2191,United,LAX,DEN,17,46,44,13,1,104
2192,American,ATL,SEA,20,38,53,10,8,109
2193,Delta,LAX,BOS,4,51,55,6,19,131
2194,United,LAX,BOS,22,0,45,3,5,53
2195,United,ORD,PHX,22,3,50,14,20,87
2196,American,LAX,PHX,19,23,45,7,23,98
2197,Southwest,ORD,PHX,2,11,45,7,21,84
2198,Southwest,JFK,SEA,9,4,2,5,6,17
2199,American,DFW,MIA,20,36,4,7,27,74
2200,United,DFW,PHX,12,0,51,10,5,66
2201,United,ATL,BOS,16,2,4,11,20,37
2202,United,DFW,MIA,23,34,39,14,1,88
2203,American,LAX,SEA,21,10,9,9,3,31
2204,American,LAX,MIA,16,8,2,7,10,27
2205,United,DFW,SEA,20,46,6,1,2,55
2206,Southwest,DFW,SEA,5,44,22,8,3,77
2207,United,DFW,BOS,9,44,22,2,20,88
2208,Southwest,ORD,MIA,21,53,55,12,18,138
2209,United,ORD,PHX,0,55,15,7,2,79
2210,Southwest,ORD,PHX,20,19,29,14,2,64
2211,JetBlue,JFK,SEA,17,19,40,5,9,73
2212,United,JFK,MIA,7,25,33,7,23,88
2213,Southwest,ATL,PHX,9,43,49,6,19,117
2214,JetBlue,ATL,PHX,20,8,10,7,23,48
2215,Southwest,LAX,SEA,7,3,29,8,5,45
2216,JetBlue,ATL,BOS,22,15,33,11,6,65
2217,United,DFW,DEN,18,20,25,7,0,52
2218,American,ATL,SEA,15,45,58,14,26,143
2219,Delta,JFK,PHX,2,3,53,6,9,71
2220,American,LAX,MIA,20,26,7,4,21,58
2221,Southwest,ORD,PHX,18,56,28,8,22,114
2222,Delta,JFK,SEA,0,34,50,0,28,112
2223,United,LAX,SEA,20,55,33,7,8,103
2224,United,JFK,BOS,21,14,52,5,19,90
2225,American,LAX,PHX,23,10,36,14,4,64
2226,JetBlue,JFK,SEA,13,52,5,12,11,80
2227,JetBlue,LAX,PHX,10,51,26,0,26,103
2228,Southwest,ATL,SEA,8,6,25,8,25,64
2229,Delta,LAX,SEA,12,21,26,13,0,60
2230,JetBlue,ORD,DEN,2,33,13,10,12,68
2231,JetBlue,JFK,MIA,18,30,34,9,24,97
2232,United,DFW,DEN,9,34,22,14,19,89
2233,JetBlue,DFW,DEN,20,56,45,1,11,113
2234,United,DFW,BOS,10,35,57,11,4,107
2235,JetBlue,LAX,BOS,15,14,3,9,21,47
2236,Delta,JFK,MIA,20,53,42,7,6,108
2237,JetBlue,ORD,MIA,11,52,16,2,16,86
2238,Southwest,ORD,SEA,20,39,58,4,22,123
2239,JetBlue,ORD,PHX,12,43,26,14,15,98
2240,Delta,DFW,BOS,4,12,8,6,22,48
2241,Delta,ORD,DEN,14,11,57,14,25,107
2242,Delta,JFK,DEN,22,31,52,6,10,99
2243,Southwest,ATL,MIA,8,41,16,1,9,67
2244,JetBlue,ORD,SEA,9,48,50,0,16,114
2245,JetBlue,LAX,MIA,3,27,25,6,8,66
2246,Delta,LAX,PHX,2,54,28,1,8,91
2247,Southwest,ORD,SEA,11,49,1,12,16,78
2248,Delta,JFK,SEA,22,27,59,9,6,101
2249,JetBlue,DFW,DEN,23,46,24,0,20,90
2250,American,LAX,DEN,8,22,14,2,8,46
2251,Delta,ORD,PHX,20,22,35,3,26,86
2252,JetBlue,ORD,PHX,20,49,45,8,10,112
2253,American,LAX,BOS,6,25,39,9,13,86
2254,Southwest,ORD,SEA,5,16,15,1,5,37
2255,American,ATL,MIA,20,54,42,11,0,107
2256,JetBlue,ATL,MIA,7,49,7,1,14,71
2257,United,LAX,PHX,8,16,47,0,17,80
2258,Southwest,DFW,PHX,12,29,15,12,26,82
2259,American,ORD,BOS,19,19,12,11,22,64
2260,JetBlue,ATL,BOS,22,9,55,11,4,79
2261,JetBlue,ORD,MIA,20,58,54,13,27,152
2262,American,ORD,DEN,5,55,55,5,7,122
2263,American,ATL,MIA,13,53,12,13,1,79
2264,United,DFW,MIA,19,21,50,14,11,96
2265,Southwest,ATL,SEA,12,3,29,12,25,69
2266,JetBlue,ATL,BOS,20,12,35,7,10,64
2267,American,LAX,MIA,9,30,43,14,29,116
2268,American,JFK,SEA,10,8,40,11,20,79
2269,United,ATL,MIA,9,35,42,13,17,107
2270,Delta,LAX,DEN,2,15,56,7,1,79
2271,Southwest,DFW,DEN,6,25,6,10,10,51
2272,Delta,DFW,SEA,14,26,52,7,10,95
2273,American,LAX,SEA,14,36,12,2,16,66
2274,American,ORD,SEA,11,40,4,11,15,70
2275,Delta,LAX,PHX,1,28,4,10,23,65
2276,JetBlue,ORD,BOS,12,25,18,12,25,80
2277,JetBlue,ATL,DEN,18,43,20,4,4,71
2278,JetBlue,DFW,MIA,10,22,13,3,19,57
2279,Delta,LAX,DEN,15,19,52,10,9,90
2280,United,DFW,MIA,5,7,40,11,18,76
2281,Delta,ATL,SEA,14,13,42,5,8,68
2282,JetBlue,DFW,MIA,13,57,3,6,13,79
2283,American,ORD,SEA,10,27,29,2,1,59
2284,JetBlue,JFK,MIA,9,27,31,1,27,86
2285,American,LAX,DEN,7,48,58,6,26,138
2286,Southwest,LAX,MIA,9,13,52,6,8,79
2287,JetBlue,ATL,PHX,14,9,33,14,2,58
2288,American,ATL,MIA,5,16,7,6,7,36
2289,JetBlue,DFW,SEA,15,18,2,0,16,36
2290,United,ATL,MIA,22,48,22,4,29,103
2291,Delta,ORD,PHX,11,34,58,10,1,103
2292,Delta,DFW,DEN,4,40,36,14,20,110
2293,JetBlue,ATL,BOS,15,21,8,4,25,58
2294,JetBlue,DFW,PHX,14,14,37,8,6,65
2295,JetBlue,LAX,PHX,3,20,11,5,16,52
2296,Delta,LAX,BOS,16,24,3,6,20,53
2297,Delta,ATL,SEA,18,16,32,13,13,74
2298,Delta,JFK,PHX,14,2,57,7,7,73
2299,United,DFW,MIA,12,53,36,1,4,94
2300,United,JFK,BOS,10,50,49,13,18,130
2301,United,DFW,SEA,3,54,49,9,19,131
2302,Delta,LAX,SEA,0,35,58,0,7,100
2303,American,LAX,PHX,13,14,29,10,9,62
2304,American,ATL,SEA,21,49,44,11,19,123
2305,Southwest,ATL,MIA,19,0,29,9,29,67
2306,Delta,ORD,MIA,0,7,24,13,26,70
2307,JetBlue,LAX,SEA,1,5,57,6,13,81
2308,JetBlue,JFK,DEN,5,0,37,8,1,46
2309,Delta,ORD,DEN,8,53,16,14,9,92
2310,American,ORD,PHX,21,2,30,13,23,68
2311,JetBlue,ATL,SEA,21,46,28,7,29,110
2312,American,JFK,MIA,3,37,28,8,26,99
2313,United,DFW,BOS,15,14,54,5,10,83
2314,JetBlue,JFK,PHX,23,35,33,2,18,88
2315,JetBlue,ATL,BOS,7,51,19,10,4,84
2316,American,DFW,BOS,11,44,57,0,23,124
2317,Southwest,ORD,DEN,21,39,29,3,20,91
2318,United,ATL,MIA,21,4,59,14,16,93
2319,JetBlue,ATL,SEA,22,39,5,5,17,66
2320,United,JFK,SEA,11,30,24,8,13,75
2321,Southwest,ATL,DEN,20,9,25,0,18,52
2322,Delta,DFW,MIA,1,55,11,10,9,85
2323,JetBlue,JFK,MIA,3,23,37,2,17,79
2324,Southwest,DFW,SEA,2,23,50,5,7,85
2325,Southwest,ORD,PHX,6,3,33,7,13,56
2326,JetBlue,JFK,DEN,9,16,36,0,18,70
2327,Southwest,DFW,BOS,11,11,12,8,20,51
2328,United,LAX,DEN,1,47,9,10,28,94
2329,JetBlue,ATL,BOS,17,21,9,8,29,67
2330,Delta,ATL,SEA,4,45,1,2,5,53
2331,Delta,ATL,MIA,3,12,27,4,21,64
2332,JetBlue,ATL,DEN,13,11,36,10,29,86
2333,Delta,JFK,PHX,22,36,52,2,24,114
2334,Southwest,JFK,MIA,9,41,58,0,16,115
2335,Southwest,DFW,SEA,20,56,14,2,24,96
2336,Delta,ATL,SEA,5,38,38,1,11,88
2337,Delta,ORD,PHX,3,55,3,11,27,96
2338,Delta,ORD,DEN,13,28,45,14,10,97
2339,Southwest,JFK,PHX,19,6,22,12,23,63
2340,JetBlue,LAX,PHX,21,1,39,7,14,61
2341,United,LAX,PHX,5,7,8,13,3,31
2342,Delta,JFK,PHX,4,40,35,4,25,104
2343,Delta,ORD,PHX,20,52,36,4,22,114
2344,JetBlue,DFW,DEN,11,9,24,9,6,48
2345,United,ORD,PHX,10,16,29,12,2,59
2346,Delta,JFK,PHX,23,31,22,0,15,68
2347,Southwest,ATL,PHX,17,57,15,5,10,87
2348,American,ATL,SEA,13,46,48,13,8,115
2349,Delta,ORD,DEN,15,32,58,12,24,126
2350,Southwest,DFW,MIA,2,19,37,14,21,91
2351,JetBlue,LAX,MIA,16,37,2,14,10,63
2352,Southwest,JFK,DEN,12,59,23,13,29,124
2353,United,ORD,DEN,13,13,22,13,13,61
2354,Delta,ORD,DEN,10,16,11,0,26,53
2355,Delta,ORD,DEN,16,21,56,2,25,104
2356,Southwest,ATL,BOS,23,18,13,11,21,63
2357,United,JFK,BOS,5,20,17,10,7,54
2358,American,DFW,SEA,16,8,34,6,24,72
2359,American,LAX,PHX,20,30,4,0,1,35
2360,United,ATL,PHX,20,32,16,9,14,71
2361,Southwest,JFK,DEN,5,54,40,9,18,121
2362,Delta,JFK,BOS,14,46,3,8,13,70
2363,American,DFW,MIA,22,59,21,7,2,89
2364,JetBlue,ATL,SEA,2,42,33,1,20,96
2365,American,JFK,PHX,0,4,24,8,0,36
2366,United,ORD,BOS,21,34,52,9,11,106
2367,Southwest,LAX,SEA,0,35,5,11,18,69
2368,JetBlue,JFK,BOS,17,3,8,3,20,34
2369,American,ATL,MIA,23,6,14,11,16,47
2370,JetBlue,ATL,MIA,8,41,37,1,26,105
2371,Delta,ATL,BOS,5,59,23,3,6,91
2372,Delta,ATL,DEN,0,12,43,10,23,88
2373,United,ORD,DEN,3,33,2,9,28,72
2374,Delta,ORD,BOS,3,24,51,14,17,106
2375,Delta,JFK,SEA,0,48,35,11,11,105
2376,Delta,JFK,MIA,23,8,6,12,14,40
2377,JetBlue,ORD,SEA,22,33,21,7,14,75
2378,United,DFW,SEA,5,22,19,14,10,65
2379,American,ORD,PHX,16,28,58,11,23,120
2380,JetBlue,DFW,MIA,17,58,57,0,26,141
2381,United,ATL,DEN,19,48,4,6,29,87
2382,Southwest,ATL,BOS,7,8,42,9,14,73
2383,Southwest,ATL,MIA,4,41,28,9,7,85
2384,American,DFW,DEN,18,49,26,8,11,94
2385,United,ORD,DEN,11,7,33,2,20,62
2386,United,LAX,MIA,19,24,47,0,21,92
2387,JetBlue,ORD,SEA,23,50,54,4,7,115
2388,United,JFK,PHX,15,6,6,4,20,36
2389,Southwest,ORD,DEN,23,41,42,4,21,108
2390,JetBlue,JFK,MIA,22,19,52,14,20,105
2391,JetBlue,ATL,SEA,1,51,49,14,26,140
2392,Southwest,LAX,MIA,1,59,7,12,11,89
2393,United,ORD,SEA,9,58,30,6,10,104
2394,United,ATL,MIA,17,11,7,1,13,32
2395,Southwest,ATL,BOS,18,28,38,5,0,71
2396,Southwest,ORD,BOS,18,9,31,12,13,65
2397,United,ORD,BOS,2,40,8,2,23,73
2398,Delta,DFW,BOS,11,5,56,7,21,89
2399,American,JFK,MIA,9,33,13,9,18,73
2400,Delta,ATL,SEA,6,16,49,10,15,90
2401,JetBlue,ORD,BOS,21,23,24,1,15,63
2402,JetBlue,ATL,MIA,11,43,4,6,5,58
2403,Delta,JFK,DEN,5,35,22,13,22,92
2404,Southwest,JFK,DEN,22,1,42,11,3,57
2405,United,LAX,PHX,1,9,48,12,1,70
2406,Delta,DFW,SEA,18,7,23,13,29,72
2407,American,ORD,MIA,2,18,58,10,21,107
2408,American,ATL,BOS,17,28,53,5,23,109
2409,American,JFK,DEN,2,26,22,8,28,84
2410,Southwest,ATL,BOS,21,46,6,7,7,66
2411,Delta,ATL,PHX,2,33,36,7,4,80
2412,United,ORD,PHX,3,33,22,8,16,79
2413,Delta,JFK,BOS,17,38,34,4,9,85
2414,Southwest,LAX,PHX,8,58,9,0,8,75
2415,United,JFK,PHX,18,22,42,7,20,91
2416,American,JFK,MIA,19,42,46,7,28,123
2417,United,LAX,PHX,1,21,19,11,8,59
2418,American,LAX,SEA,12,53,53,13,0,119
2419,Delta,LAX,SEA,23,54,28,0,18,100
2420,JetBlue,LAX,SEA,0,42,9,14,11,76
2421,United,DFW,MIA,22,54,38,2,2,96
2422,United,ATL,DEN,1,46,59,12,18,135
2423,American,JFK,BOS,22,12,54,8,19,93
2424,American,ATL,PHX,19,9,11,3,2,25
2425,JetBlue,ATL,DEN,11,22,12,7,8,49
2426,Delta,ATL,SEA,15,49,23,0,10,82
2427,United,LAX,DEN,9,12,46,0,8,66
2428,American,DFW,MIA,7,48,6,1,25,80
2429,Southwest,DFW,DEN,11,52,3,3,15,73
2430,American,JFK,BOS,20,21,52,6,5,84
2431,Southwest,LAX,BOS,21,13,24,7,18,62
2432,Southwest,ORD,MIA,1,12,52,1,0,65
2433,JetBlue,JFK,PHX,16,1,46,7,13,67
2434,JetBlue,ATL,DEN,11,30,31,3,1,65
2435,Delta,DFW,PHX,3,31,47,11,0,89
2436,United,LAX,MIA,8,54,27,6,4,91
2437,American,LAX,MIA,5,57,14,9,22,102
2438,Delta,JFK,DEN,6,41,2,14,16,73
2439,American,ORD,DEN,13,14,28,4,26,72
2440,American,ORD,SEA,18,30,46,0,15,91
2441,United,JFK,DEN,3,14,2,7,3,26
2442,JetBlue,JFK,MIA,7,13,42,0,22,77
2443,American,ATL,DEN,17,26,42,9,21,98
2444,JetBlue,JFK,SEA,16,42,4,10,5,61
2445,United,LAX,BOS,12,15,1,9,19,44
2446,United,LAX,MIA,4,47,39,14,11,111
2447,American,ATL,PHX,0,46,33,1,2,82
2448,JetBlue,ORD,PHX,10,53,9,5,29,96
2449,Southwest,DFW,SEA,21,58,39,13,15,125
2450,United,LAX,BOS,2,20,14,4,26,64
2451,JetBlue,ATL,MIA,7,31,54,12,14,111
2452,American,DFW,SEA,0,35,29,13,21,98
2453,Southwest,JFK,MIA,1,13,54,4,29,100
2454,American,ORD,MIA,15,21,1,7,1,30
2455,American,JFK,SEA,14,34,26,0,14,74
2456,United,JFK,BOS,3,30,24,10,2,66
2457,United,LAX,PHX,10,27,1,14,23,65
2458,United,DFW,BOS,8,36,57,3,14,110
2459,United,ORD,DEN,3,54,53,11,5,123
2460,Delta,ATL,PHX,10,43,15,12,11,81
2461,Delta,ORD,MIA,16,31,22,8,24,85
2462,Southwest,DFW,SEA,15,50,33,7,9,99
2463,Southwest,ORD,BOS,19,46,59,6,11,122
2464,Southwest,LAX,PHX,8,14,53,3,0,70
2465,Delta,DFW,PHX,20,4,25,3,8,40
2466,United,DFW,SEA,15,57,45,5,10,117
2467,American,ATL,PHX,6,42,38,7,3,90
2468,Southwest,ATL,SEA,6,50,15,14,19,98
2469,American,JFK,BOS,4,14,40,11,3,68
2470,American,LAX,BOS,22,55,52,3,21,131
2471,Southwest,DFW,BOS,16,12,10,11,0,33
2472,Southwest,ATL,PHX,18,35,23,14,3,75
2473,American,ATL,MIA,18,0,34,1,29,64
2474,Delta,JFK,MIA,6,26,53,11,18,108
2475,American,JFK,PHX,13,28,20,2,9,59
2476,United,LAX,DEN,22,15,36,8,21,80
2477,Southwest,ORD,SEA,20,44,38,11,9,102
2478,Southwest,JFK,DEN,2,37,28,11,11,87
2479,United,DFW,SEA,6,54,6,5,15,80
2480,United,JFK,DEN,1,3,15,14,20,52
2481,United,JFK,MIA,17,37,1,3,18,59
2482,United,LAX,BOS,7,8,26,4,8,46
2483,United,LAX,DEN,15,10,53,2,20,85
2484,United,DFW,DEN,22,0,38,0,21,59
2485,American,ATL,SEA,22,18,33,10,8,69
2486,United,DFW,DEN,3,12,30,12,20,74
2487,Delta,LAX,MIA,1,10,32,2,13,57
2488,American,JFK,PHX,15,2,33,5,24,64
2489,Southwest,ORD,SEA,20,30,59,7,26,122
2490,United,ATL,BOS,5,18,26,9,0,53
2491,United,JFK,DEN,0,9,10,14,25,58
2492,JetBlue,JFK,DEN,0,15,5,3,22,45
2493,Southwest,DFW,PHX,5,46,27,12,16,101
2494,American,JFK,MIA,19,55,1,12,7,75
2495,JetBlue,ORD,DEN,14,57,36,5,14,112
2496,Southwest,ORD,DEN,13,10,50,12,11,83
2497,American,ORD,DEN,2,41,7,6,7,61
2498,Delta,DFW,SEA,2,23,48,14,2,87
2499,United,JFK,MIA,9,29,32,7,16,84
2500,American,ORD,DEN,1,35,27,14,8,84
2501,Delta,ATL,PHX,12,51,30,11,4,96
2502,United,ORD,PHX,13,59,13,0,4,76
2503,United,LAX,BOS,21,36,0,4,9,49
2504,American,ATL,BOS,7,8,52,10,24,94
2505,American,DFW,MIA,12,21,18,2,27,68
2506,Southwest,JFK,BOS,5,47,3,2,10,62
2507,Delta,ATL,MIA,0,14,48,6,25,93
2508,United,ORD,PHX,6,46,35,11,13,105
2509,Southwest,ATL,SEA,15,24,4,10,21,59
2510,Delta,DFW,MIA,9,48,38,1,21,108
2511,JetBlue,JFK,BOS,16,21,51,6,3,81
2512,JetBlue,ORD,PHX,22,23,44,11,2,80
2513,American,DFW,BOS,20,47,40,11,16,114
2514,American,ORD,SEA,20,5,32,2,12,51
2515,Southwest,DFW,BOS,11,14,14,2,12,42
2516,Southwest,ATL,PHX,23,10,31,6,3,50
2517,American,DFW,PHX,16,25,23,1,3,52
2518,Southwest,LAX,SEA,5,54,24,1,10,89
2519,Delta,ORD,MIA,16,54,27,2,11,94
2520,JetBlue,DFW,PHX,23,39,41,0,15,95
2521,United,ORD,PHX,19,14,31,11,8,64
2522,Delta,DFW,MIA,2,19,50,12,11,92
2523,United,LAX,PHX,19,19,11,12,5,47
2524,JetBlue,ORD,DEN,23,40,46,4,7,97
2525,American,JFK,MIA,21,28,37,2,3,70
2526,JetBlue,JFK,DEN,1,22,43,1,9,75
2527,American,ORD,SEA,4,45,33,6,4,88
2528,Southwest,ATL,BOS,2,30,1,4,1,36
2529,United,ATL,PHX,1,36,26,14,9,85
2530,Delta,ORD,MIA,9,36,22,6,8,72
2531,Delta,JFK,BOS,1,59,57,2,18,136
2532,United,ORD,DEN,10,19,3,12,11,45
2533,JetBlue,ATL,SEA,15,37,3,4,18,62
2534,Delta,DFW,PHX,2,6,1,10,23,40
2535,United,DFW,DEN,9,26,53,7,23,109
2536,American,ATL,MIA,6,3,14,13,2,32
2537,United,ATL,SEA,1,54,10,4,8,76
2538,JetBlue,JFK,PHX,7,54,23,13,24,114
2539,United,LAX,DEN,0,45,9,2,7,63
2540,American,DFW,MIA,17,42,9,5,13,69
2541,Southwest,ORD,SEA,15,57,2,14,17,90
2542,Delta,LAX,DEN,23,10,40,14,13,77
2543,United,ORD,PHX,12,31,24,3,26,84
2544,Delta,LAX,BOS,0,22,21,12,10,65
2545,Southwest,DFW,DEN,13,43,27,3,16,89
2546,United,ATL,PHX,19,37,12,9,17,75
2547,Delta,ATL,DEN,9,51,2,13,0,66
2548,Southwest,DFW,SEA,16,48,51,11,13,123
2549,American,JFK,SEA,16,56,48,12,8,124
2550,American,ORD,DEN,16,7,51,7,3,68
2551,Delta,DFW,PHX,18,11,39,6,7,63
2552,Delta,LAX,BOS,16,39,45,1,15,100
2553,United,DFW,MIA,21,20,54,4,29,107
2554,United,LAX,BOS,12,33,7,3,14,57
2555,American,JFK,SEA,5,31,41,3,2,77
2556,American,ORD,BOS,12,13,0,13,11,37
2557,American,JFK,SEA,0,45,1,7,14,67
2558,United,DFW,MIA,9,3,54,5,3,65
2559,United,ATL,MIA,20,51,29,8,13,101
2560,JetBlue,DFW,SEA,1,6,11,2,29,48
2561,Southwest,LAX,PHX,3,48,37,8,27,120
2562,JetBlue,DFW,MIA,18,21,32,0,17,70
2563,Delta,DFW,PHX,18,0,17,9,20,46
2564,Delta,ORD,SEA,9,43,17,6,28,94
2565,Delta,LAX,SEA,8,28,59,11,22,120
2566,United,ORD,BOS,3,19,16,5,20,60
2567,United,DFW,DEN,10,58,39,14,5,116
2568,Delta,LAX,SEA,9,45,4,11,13,73
2569,United,ORD,MIA,20,44,15,9,8,76
2570,Delta,ATL,PHX,22,3,58,10,17,88
2571,Delta,JFK,DEN,19,55,18,11,23,107
2572,Delta,LAX,MIA,21,13,14,8,3,38
2573,JetBlue,LAX,PHX,11,48,15,11,16,90
2574,United,ORD,MIA,2,44,16,13,22,95
2575,JetBlue,ATL,DEN,5,20,52,2,27,101
2576,JetBlue,DFW,MIA,21,5,38,5,13,61
2577,American,LAX,BOS,21,13,30,13,29,85
2578,American,JFK,BOS,15,40,6,4,20,70
2579,United,ATL,SEA,19,18,18,3,5,44
2580,Delta,LAX,BOS,22,42,2,6,9,59
2581,Delta,ORD,DEN,2,46,39,2,10,97
2582,JetBlue,ATL,DEN,8,3,45,5,18,71
2583,Southwest,ATL,DEN,19,43,41,3,2,89
2584,Delta,JFK,PHX,2,39,38,6,2,85
2585,American,LAX,BOS,4,30,54,0,29,113
2586,United,DFW,PHX,15,35,2,7,25,69
2587,American,ATL,MIA,23,39,3,1,12,55
2588,American,JFK,BOS,18,56,50,0,23,129
2589,JetBlue,DFW,PHX,4,9,0,4,27,40
2590,American,ORD,SEA,15,23,50,3,4,80
2591,Southwest,LAX,BOS,9,48,12,1,11,72
2592,Southwest,ATL,SEA,5,41,22,1,4,68
2593,American,ORD,PHX,0,43,2,7,2,54
2594,American,ORD,MIA,10,52,29,14,10,105
2595,Delta,LAX,DEN,1,46,27,10,3,86
2596,United,LAX,DEN,1,52,46,1,4,103
2597,American,JFK,SEA,1,39,39,13,25,116
2598,United,JFK,BOS,20,9,9,11,1,30
2599,United,DFW,SEA,22,45,23,13,25,106
2600,Southwest,ORD,SEA,4,2,26,1,20,49
2601,JetBlue,LAX,DEN,6,3,49,10,6,68
2602,Southwest,LAX,MIA,12,57,9,2,8,76
2603,Southwest,ORD,BOS,22,35,18,8,7,68
2604,United,LAX,DEN,19,42,55,6,1,104
2605,JetBlue,ORD,DEN,21,36,26,8,5,75
2606,Delta,LAX,PHX,7,3,32,8,29,72
2607,JetBlue,LAX,SEA,1,16,4,7,23,50
2608,Southwest,JFK,DEN,16,35,52,3,28,118
2609,American,JFK,SEA,1,37,50,10,18,115
2610,Delta,DFW,SEA,18,56,20,10,9,95
2611,Delta,ATL,BOS,5,16,3,3,21,43
2612,JetBlue,LAX,DEN,6,53,27,6,2,88
2613,JetBlue,LAX,MIA,14,39,44,0,27,110
2614,JetBlue,ATL,DEN,1,47,55,2,13,117
2615,Southwest,ORD,PHX,23,34,59,6,19,118
2616,Delta,DFW,MIA,0,36,33,1,13,83
2617,United,DFW,PHX,7,34,38,11,22,105
2618,American,DFW,PHX,3,11,30,6,20,67
2619,American,LAX,PHX,23,49,13,9,4,75
2620,United,LAX,DEN,20,39,25,13,15,92
2621,American,ORD,SEA,6,44,39,5,12,100
2622,Southwest,ORD,PHX,7,54,33,13,13,113
2623,Southwest,DFW,BOS,4,51,29,9,16,105
2624,United,DFW,BOS,12,20,33,6,28,87
2625,JetBlue,JFK,MIA,14,5,5,3,14,27
2626,JetBlue,DFW,DEN,10,14,48,8,24,94
2627,Delta,ORD,DEN,12,32,30,12,10,84
2628,American,DFW,DEN,11,59,59,6,11,135
2629,Southwest,LAX,DEN,17,30,15,3,21,69
2630,JetBlue,ORD,DEN,13,38,21,14,29,102
2631,United,LAX,MIA,2,55,34,7,18,114
2632,United,ATL,BOS,10,58,43,12,13,126
2633,American,LAX,SEA,23,56,31,9,28,124
2634,Delta,JFK,DEN,5,0,12,0,28,40
2635,JetBlue,ORD,PHX,9,26,20,13,29,88
2636,American,ORD,PHX,10,35,36,0,27,98
2637,JetBlue,JFK,MIA,22,12,38,3,13,66
2638,American,LAX,SEA,9,31,2,12,15,60
2639,United,DFW,BOS,20,29,25,7,22,83
2640,American,DFW,SEA,3,20,48,7,20,95
2641,Delta,ATL,PHX,10,21,38,5,2,66
2642,American,JFK,MIA,6,7,37,10,26,80
2643,Southwest,ORD,SEA,14,16,49,9,20,94
2644,United,ATL,PHX,8,46,10,10,16,82
2645,American,ATL,SEA,2,54,1,10,26,91
2646,JetBlue,LAX,SEA,22,9,3,3,1,16
2647,Southwest,JFK,MIA,22,56,22,7,11,96
2648,Delta,ORD,MIA,18,4,4,13,20,41
2649,Delta,LAX,PHX,4,53,42,2,0,97
2650,Delta,DFW,MIA,16,28,40,12,2,82
2651,American,ATL,DEN,18,53,9,11,9,82
2652,Southwest,JFK,MIA,15,55,49,2,3,109
2653,Southwest,ORD,DEN,13,29,25,3,7,64
2654,United,LAX,BOS,5,45,24,12,11,92
2655,Delta,DFW,BOS,4,20,41,3,6,70
2656,American,JFK,DEN,5,13,14,9,21,57
2657,JetBlue,LAX,MIA,7,8,15,12,24,59
2658,Southwest,DFW,MIA,19,4,10,4,8,26
2659,JetBlue,LAX,BOS,14,30,18,2,22,72
2660,JetBlue,JFK,PHX,0,28,0,5,4,37
2661,Delta,LAX,DEN,2,18,38,4,16,76
2662,JetBlue,ORD,MIA,11,43,15,3,8,69
2663,JetBlue,ORD,BOS,17,25,53,1,3,82
2664,JetBlue,DFW,BOS,11,33,53,13,23,122
2665,American,ATL,MIA,3,22,40,0,12,74
2666,Delta,ATL,BOS,14,45,48,2,10,105
2667,JetBlue,ORD,BOS,7,55,40,13,5,113
2668,Delta,ORD,SEA,3,0,58,11,19,88
2669,Southwest,JFK,PHX,4,15,27,3,28,73
2670,JetBlue,ORD,BOS,19,25,52,9,3,89
2671,JetBlue,ORD,SEA,8,49,20,4,4,77
2672,Delta,DFW,MIA,3,29,1,2,7,39
2673,American,LAX,DEN,0,25,21,4,4,54
2674,Southwest,LAX,DEN,14,44,3,9,11,67
2675,JetBlue,DFW,SEA,14,4,42,4,18,68
2676,United,LAX,PHX,15,15,32,2,15,64
2677,JetBlue,ORD,PHX,0,14,28,5,1,48
2678,United,DFW,DEN,16,33,36,12,9,90
2679,American,JFK,BOS,1,48,0,0,3,51
2680,Delta,LAX,PHX,4,14,31,14,27,86
2681,American,ORD,SEA,18,21,49,14,20,104
2682,Southwest,JFK,BOS,13,23,50,0,3,76
2683,American,ATL,BOS,18,14,55,1,6,76
2684,United,JFK,DEN,7,44,46,8,3,101
2685,United,ATL,BOS,14,4,51,8,4,67
2686,JetBlue,ORD,DEN,3,58,5,5,29,97
2687,United,ATL,SEA,17,9,29,3,6,47
2688,JetBlue,JFK,PHX,21,57,8,14,27,106
2689,United,ORD,MIA,1,25,9,12,22,68
2690,Delta,JFK,MIA,0,1,50,1,15,67
2691,United,ATL,BOS,16,53,2,13,6,74
2692,Southwest,LAX,BOS,15,41,52,12,2,107
2693,Southwest,JFK,SEA,22,12,19,5,15,51
2694,Southwest,DFW,SEA,12,50,46,8,1,105
2695,American,DFW,BOS,17,58,34,14,25,131
2696,JetBlue,DFW,BOS,12,26,30,6,16,78
2697,American,ORD,SEA,18,0,7,10,14,31
2698,American,ATL,PHX,6,2,23,4,13,42
2699,Delta,ATL,DEN,2,41,28,0,7,76
2700,JetBlue,JFK,BOS,10,9,30,7,27,73
2701,Southwest,DFW,SEA,16,29,56,2,29,116
2702,Southwest,ORD,SEA,18,58,5,9,21,93
2703,Southwest,DFW,BOS,14,9,34,5,3,51
2704,American,DFW,SEA,9,31,2,1,8,42
2705,American,ORD,PHX,21,19,57,14,15,105
2706,Southwest,JFK,BOS,7,13,48,4,29,94
2707,Delta,DFW,PHX,0,32,26,14,28,100
2708,JetBlue,JFK,MIA,18,11,20,4,22,57
2709,Southwest,LAX,PHX,21,49,36,14,0,99
2710,Delta,ORD,MIA,8,53,5,13,5,76
2711,JetBlue,ORD,PHX,9,23,5,9,16,53
2712,United,JFK,SEA,5,52,4,9,0,65
2713,JetBlue,DFW,SEA,15,24,39,12,0,75
2714,United,DFW,DEN,10,36,18,4,10,68
2715,American,LAX,BOS,21,52,12,11,26,101
2716,Southwest,LAX,SEA,4,36,9,14,28,87
2717,Southwest,ATL,DEN,14,46,43,9,2,100
2718,JetBlue,ATL,SEA,0,6,38,13,4,61
2719,American,ORD,MIA,12,4,13,12,10,39
2720,Southwest,LAX,PHX,2,38,15,10,25,88
2721,American,JFK,DEN,7,57,32,7,17,113
2722,JetBlue,DFW,MIA,20,26,53,0,28,107
2723,United,ORD,SEA,4,7,53,8,24,92
2724,JetBlue,LAX,BOS,15,50,56,6,10,122
2725,JetBlue,JFK,MIA,21,26,50,0,14,90
2726,JetBlue,ORD,DEN,22,3,59,7,28,97
2727,Southwest,LAX,MIA,22,41,16,2,15,74
2728,Southwest,LAX,MIA,2,10,51,6,6,73
2729,American,ATL,PHX,5,53,22,0,6,81
2730,JetBlue,JFK,SEA,9,10,15,0,11,36
2731,American,LAX,MIA,12,39,32,6,6,83
2732,American,DFW,DEN,1,57,25,14,23,119
2733,United,DFW,DEN,14,52,41,14,23,130
2734,United,JFK,DEN,16,37,50,7,12,106
2735,American,DFW,MIA,14,10,34,7,27,78
2736,Southwest,ATL,BOS,9,13,38,10,14,75
2737,Southwest,JFK,BOS,3,11,35,6,24,76
2738,JetBlue,LAX,PHX,21,16,20,8,9,53
2739,United,LAX,SEA,8,23,34,5,16,78
2740,American,DFW,SEA,1,20,27,2,20,69
2741,Delta,ATL,BOS,3,10,37,5,6,58
2742,Delta,DFW,MIA,4,8,29,0,23,60
2743,United,DFW,DEN,2,37,36,4,8,85
2744,American,ATL,PHX,5,12,41,3,25,81
2745,Southwest,DFW,BOS,6,41,36,4,11,92
2746,American,LAX,SEA,6,31,33,7,26,97
2747,JetBlue,ATL,SEA,16,16,9,11,28,64
2748,JetBlue,ORD,PHX,14,12,36,5,25,78
2749,American,ORD,MIA,15,24,0,1,10,35
2750,Southwest,JFK,SEA,14,39,46,0,18,103
2751,United,ORD,DEN,23,49,3,10,6,68
2752,American,ATL,DEN,15,0,28,12,15,55
2753,Delta,ORD,BOS,23,22,15,12,11,60
2754,Southwest,ORD,BOS,15,59,43,7,21,130
2755,American,ATL,DEN,13,36,18,6,17,77
2756,JetBlue,LAX,DEN,23,25,5,1,10,41
2757,American,ATL,MIA,19,55,57,4,11,127
2758,Delta,ORD,MIA,4,38,5,0,12,55
2759,Delta,ORD,BOS,2,15,31,11,12,69
2760,Delta,LAX,BOS,4,19,49,2,6,76
2761,Southwest,DFW,BOS,12,36,59,12,0,107
2762,Delta,JFK,SEA,18,37,35,9,14,95
2763,JetBlue,ATL,MIA,5,38,46,10,12,106
2764,United,ATL,MIA,16,16,28,4,28,76
2765,JetBlue,JFK,DEN,18,3,56,1,24,84
2766,United,DFW,PHX,20,58,42,8,22,130
2767,United,ORD,MIA,10,54,2,10,25,91
2768,American,LAX,MIA,1,34,7,1,17,59
2769,American,JFK,BOS,16,23,26,6,16,71
2770,American,LAX,SEA,19,44,58,10,28,140
2771,American,LAX,SEA,7,9,2,3,20,34
2772,American,ATL,SEA,10,12,32,6,11,61
2773,Southwest,DFW,SEA,18,31,46,9,11,97
2774,Southwest,JFK,SEA,7,0,5,3,0,8
2775,JetBlue,ORD,DEN,15,18,12,7,8,45
2776,Delta,DFW,BOS,9,4,34,3,15,56
2777,United,LAX,SEA,19,45,56,1,12,114
2778,American,DFW,BOS,5,53,32,12,18,115
2779,Delta,ATL,MIA,19,50,54,5,24,133
2780,Southwest,ATL,DEN,14,27,23,8,19,77
2781,American,ATL,MIA,18,33,36,13,2,84
2782,United,LAX,DEN,11,14,37,6,21,78
2783,Delta,ATL,PHX,5,37,27,5,26,95
2784,American,ATL,DEN,0,30,19,3,16,68
2785,United,ORD,DEN,20,47,38,9,6,100
2786,JetBlue,LAX,PHX,14,12,56,11,25,104
2787,Delta,ORD,SEA,12,36,41,11,10,98
2788,United,JFK,BOS,20,41,0,3,13,57
2789,United,JFK,PHX,4,32,13,2,19,66
2790,Southwest,ORD,SEA,12,27,15,5,26,73
2791,JetBlue,ORD,PHX,3,30,31,14,20,95
2792,Delta,ATL,MIA,16,50,24,13,28,115
2793,Delta,ATL,SEA,19,16,56,11,27,110
2794,Delta,ORD,BOS,20,48,41,7,18,114
2795,JetBlue,DFW,DEN,6,40,47,6,1,94
2796,United,ORD,DEN,1,22,4,5,4,35
2797,United,LAX,BOS,21,14,53,8,28,103
2798,Southwest,ORD,DEN,18,18,19,6,21,64
2799,Southwest,ORD,PHX,5,54,47,13,28,142
2800,JetBlue,LAX,MIA,13,51,22,2,10,85
2801,Delta,ORD,BOS,0,0,50,14,11,75
2802,Southwest,LAX,MIA,13,4,11,12,24,51
2803,Delta,ATL,MIA,0,11,7,13,22,53
2804,United,DFW,DEN,4,28,5,11,10,54
2805,JetBlue,DFW,SEA,14,38,24,7,11,80
2806,United,JFK,MIA,1,13,15,4,13,45
2807,Delta,LAX,PHX,5,48,48,2,10,108
2808,Delta,LAX,SEA,1,37,4,3,12,56
2809,Southwest,DFW,BOS,10,17,46,3,14,80
2810,American,ORD,PHX,2,54,54,11,10,129
2811,United,LAX,DEN,21,49,31,7,26,113
2812,United,ATL,MIA,13,43,52,6,10,111
2813,Delta,ORD,PHX,5,26,56,12,19,113
2814,American,DFW,PHX,0,50,2,14,10,76
2815,Delta,ATL,BOS,21,47,17,12,21,97
2816,American,JFK,PHX,17,2,55,7,26,90
2817,JetBlue,LAX,DEN,21,41,5,7,28,81
2818,American,DFW,BOS,19,43,35,7,16,101
2819,Delta,ATL,DEN,3,35,8,5,15,63
2820,Delta,DFW,BOS,12,43,37,7,28,115
2821,Southwest,LAX,SEA,17,42,33,13,0,88
2822,Southwest,DFW,SEA,9,48,54,12,15,129
2823,Delta,ATL,BOS,8,6,1,9,21,37
2824,United,ATL,SEA,14,18,37,9,18,82
2825,Southwest,ORD,PHX,23,34,36,9,23,102
2826,American,JFK,BOS,15,11,52,4,17,84
2827,American,ATL,DEN,21,16,42,1,5,64
2828,JetBlue,ORD,MIA,5,26,55,5,9,95
2829,American,JFK,SEA,22,13,40,9,0,62
2830,Delta,DFW,DEN,5,9,49,6,3,67
2831,Delta,JFK,DEN,10,56,3,6,23,88
2832,American,JFK,MIA,13,12,20,7,0,39
2833,JetBlue,DFW,SEA,11,43,39,5,16,103
2834,American,DFW,DEN,8,32,11,7,12,62
2835,Southwest,LAX,SEA,19,49,36,3,5,93
2836,Southwest,JFK,DEN,4,36,41,12,12,101
2837,Delta,LAX,MIA,21,22,44,10,19,95
2838,American,ORD,DEN,17,16,39,8,1,64
2839,JetBlue,ATL,PHX,13,36,19,7,28,90
2840,Southwest,ORD,DEN,22,54,43,11,5,113
2841,JetBlue,JFK,BOS,16,57,15,9,16,97
2842,Southwest,JFK,MIA,11,52,45,1,20,118
2843,American,DFW,SEA,1,14,34,3,26,77
2844,United,LAX,DEN,16,19,42,10,3,74
2845,JetBlue,LAX,MIA,0,4,24,10,29,67
2846,American,DFW,BOS,22,59,48,0,0,107
2847,JetBlue,ATL,PHX,23,42,4,13,10,69
2848,JetBlue,JFK,SEA,5,41,8,2,22,73
2849,American,ORD,MIA,0,7,27,9,28,71
2850,JetBlue,ORD,MIA,20,55,24,14,11,104
2851,JetBlue,ORD,PHX,12,39,4,6,27,76
2852,JetBlue,DFW,MIA,4,52,0,6,26,84
2853,United,ORD,PHX,6,31,45,8,10,94
2854,Delta,DFW,MIA,2,41,53,14,20,128
2855,JetBlue,ATL,MIA,15,55,43,3,24,125
2856,Southwest,DFW,MIA,18,22,57,13,28,120
2857,American,ATL,PHX,6,17,7,11,11,46
2858,American,ORD,DEN,21,43,49,9,11,112
2859,JetBlue,JFK,PHX,5,52,12,8,14,86
2860,United,DFW,SEA,19,21,10,12,26,69
2861,Delta,JFK,DEN,18,42,8,2,16,68
2862,Delta,JFK,DEN,22,13,1,6,12,32
2863,JetBlue,ORD,DEN,19,10,57,14,21,102
2864,Southwest,DFW,BOS,13,12,17,0,27,56
2865,United,DFW,PHX,17,49,21,4,29,103
2866,JetBlue,ATL,PHX,4,19,45,2,0,66
2867,American,DFW,MIA,16,3,34,8,16,61
2868,Southwest,JFK,MIA,12,47,50,7,28,132
2869,JetBlue,DFW,DEN,1,22,8,1,0,31
2870,Delta,LAX,MIA,13,35,41,1,3,80
2871,JetBlue,LAX,BOS,8,20,23,14,23,80
2872,JetBlue,LAX,SEA,11,1,34,8,16,59
2873,United,JFK,PHX,13,35,1,14,17,67
2874,United,LAX,MIA,18,22,56,6,6,90
2875,United,ORD,MIA,21,44,8,4,18,74
2876,United,LAX,SEA,12,18,9,13,6,46
2877,Delta,ORD,PHX,6,8,12,12,27,59
2878,JetBlue,DFW,BOS,10,30,3,0,8,41
2879,JetBlue,ATL,SEA,7,33,57,14,19,123
2880,American,DFW,DEN,16,10,51,2,22,85
2881,United,JFK,PHX,21,45,46,12,19,122
2882,United,ATL,BOS,21,32,9,2,12,55
2883,Southwest,LAX,DEN,19,33,59,0,9,101
2884,American,ORD,MIA,7,58,57,10,7,132
2885,Delta,JFK,PHX,0,54,17,12,10,93
2886,United,ATL,MIA,2,49,40,8,9,106
2887,Southwest,JFK,PHX,5,1,9,3,2,15
2888,Southwest,ATL,SEA,23,36,53,8,1,98
2889,Southwest,JFK,BOS,21,24,50,13,1,88
2890,Southwest,LAX,MIA,12,59,0,6,1,66
2891,American,ORD,PHX,15,27,6,7,5,45
2892,American,ORD,SEA,3,53,26,13,5,97
2893,Delta,LAX,SEA,16,34,26,7,27,94
2894,JetBlue,DFW,SEA,0,1,25,14,22,62
2895,United,ORD,DEN,2,59,12,5,5,81
2896,Southwest,LAX,PHX,14,9,10,8,8,35
2897,United,ATL,BOS,3,0,23,7,22,52
2898,Delta,ORD,MIA,14,15,12,7,26,60
2899,Delta,ATL,MIA,6,16,25,1,20,62
2900,Southwest,ATL,SEA,14,59,53,11,14,137
2901,United,JFK,PHX,1,20,15,8,19,62
2902,JetBlue,DFW,BOS,17,20,53,13,1,87
2903,American,DFW,MIA,21,3,49,9,12,73
2904,Delta,LAX,SEA,5,12,3,11,11,37
2905,Southwest,DFW,DEN,2,17,59,10,24,110
2906,JetBlue,ATL,SEA,17,56,26,4,29,115
2907,JetBlue,JFK,BOS,2,6,28,14,19,67
2908,United,DFW,PHX,4,38,21,5,26,90
2909,United,JFK,PHX,13,46,30,8,29,113
2910,Delta,JFK,SEA,8,57,4,5,2,68
2911,JetBlue,ORD,SEA,4,0,59,8,21,88
2912,American,ORD,BOS,8,42,28,3,6,79
2913,American,LAX,DEN,15,39,15,7,23,84
2914,American,ATL,BOS,22,39,29,1,18,87
2915,American,ORD,SEA,8,57,32,0,12,101
2916,JetBlue,JFK,MIA,20,53,22,2,1,78
2917,United,JFK,PHX,17,12,35,7,7,61
2918,Delta,ORD,SEA,8,4,1,11,5,21
2919,American,LAX,MIA,2,12,28,1,21,62
2920,Southwest,ATL,MIA,20,21,34,8,24,87
2921,Delta,LAX,DEN,11,28,19,3,14,64
2922,Delta,JFK,PHX,22,38,10,12,1,61
2923,United,LAX,MIA,21,38,38,14,8,98
2924,United,ORD,SEA,17,26,1,10,12,49
2925,United,LAX,DEN,12,35,42,0,15,92
2926,Southwest,DFW,DEN,15,34,34,6,10,84
2927,Delta,JFK,SEA,7,10,18,5,6,39
2928,Delta,ORD,MIA,4,39,30,13,23,105
2929,JetBlue,ORD,PHX,20,13,5,8,9,35
2930,Southwest,LAX,SEA,11,1,38,12,21,72
2931,American,LAX,MIA,6,21,54,12,12,99
2932,Delta,JFK,SEA,12,13,42,13,18,86
2933,Southwest,ATL,DEN,14,2,28,14,21,65
2934,Delta,JFK,SEA,19,19,5,13,14,51
2935,Delta,ATL,DEN,23,5,18,1,8,32
2936,JetBlue,DFW,DEN,21,26,8,14,7,55
2937,United,ATL,DEN,20,31,16,0,15,62
2938,JetBlue,ATL,PHX,18,41,54,4,2,101
2939,JetBlue,LAX,BOS,8,4,36,9,12,61
2940,United,DFW,SEA,17,12,22,3,3,40
2941,Delta,ORD,MIA,20,7,56,6,12,81
2942,Delta,LAX,DEN,14,8,2,6,25,41
2943,Delta,DFW,SEA,10,55,26,8,4,93
2944,Delta,ORD,BOS,7,23,35,11,0,69
2945,United,JFK,SEA,8,38,23,2,7,70
2946,American,ORD,DEN,10,16,6,6,9,37
2947,United,LAX,BOS,11,3,51,13,7,74
2948,Delta,ORD,MIA,4,8,26,3,22,59
2949,United,JFK,BOS,0,19,18,14,1,52
2950,United,JFK,DEN,3,5,45,7,26,83
2951,United,ORD,PHX,10,44,15,10,17,86
2952,United,DFW,BOS,22,52,3,7,23,85
2953,United,ATL,DEN,2,15,59,1,14,89
2954,Delta,LAX,SEA,19,33,47,12,3,95
2955,JetBlue,ATL,DEN,3,0,35,11,17,63
2956,Southwest,ATL,BOS,5,26,6,9,10,51
2957,Southwest,LAX,DEN,11,30,33,9,28,100
2958,Southwest,JFK,PHX,9,20,4,6,5,35
2959,United,ORD,DEN,14,8,44,9,16,77
2960,Southwest,JFK,DEN,12,18,30,9,26,83
2961,United,DFW,PHX,12,59,57,4,5,125
2962,JetBlue,ATL,SEA,13,24,22,3,25,74
2963,JetBlue,ATL,PHX,3,58,43,14,4,119
2964,United,JFK,MIA,12,51,13,13,27,104
2965,Southwest,DFW,PHX,20,25,59,9,0,93
2966,Delta,DFW,BOS,11,45,23,13,6,87
2967,United,LAX,DEN,20,55,47,12,24,138
2968,Southwest,LAX,MIA,7,43,3,9,22,77
2969,JetBlue,JFK,BOS,12,16,18,1,24,59
2970,American,JFK,MIA,8,33,47,14,14,108
2971,United,LAX,DEN,7,40,18,14,22,94
2972,United,JFK,SEA,16,40,2,9,28,79
2973,American,JFK,DEN,18,32,49,7,18,106
2974,JetBlue,ATL,BOS,5,25,49,12,25,111
2975,United,JFK,BOS,7,11,57,0,26,94
2976,Southwest,LAX,PHX,15,15,48,8,22,93
2977,American,JFK,DEN,19,57,54,4,22,137
2978,American,JFK,SEA,0,17,43,2,26,88
2979,American,DFW,PHX,18,52,6,0,0,58
2980,United,DFW,DEN,1,2,53,2,27,84
2981,American,ATL,BOS,8,0,9,8,23,40
2982,JetBlue,ATL,MIA,10,21,56,9,20,106
2983,Southwest,JFK,BOS,10,0,50,14,26,90
2984,American,ATL,SEA,6,28,34,0,2,64
2985,Delta,JFK,PHX,11,6,27,7,16,56
2986,Southwest,DFW,PHX,8,14,28,6,12,60
2987,United,LAX,PHX,11,53,36,3,22,114
2988,United,LAX,PHX,0,0,2,0,20,22
2989,Delta,ATL,MIA,10,15,7,14,6,42
2990,Southwest,LAX,BOS,18,53,3,2,21,79
2991,American,DFW,SEA,19,48,3,9,13,73
2992,American,LAX,SEA,22,24,48,12,23,107
2993,United,ORD,SEA,21,4,11,7,23,45
2994,Southwest,JFK,BOS,21,4,2,5,1,12
2995,Delta,ORD,MIA,3,58,52,9,11,130
2996,Delta,JFK,SEA,0,5,0,5,26,36
2997,United,DFW,SEA,21,27,25,4,17,73
2998,United,LAX,PHX,14,17,36,10,1,64
2999,Delta,LAX,DEN,1,18,24,3,2,47
3000,Southwest,ATL,SEA,22,42,37,8,18,105
3001,JetBlue,DFW,BOS,8,5,27,13,10,55
3002,Southwest,ATL,BOS,9,51,12,5,24,92
3003,American,ATL,MIA,16,30,43,14,10,97
3004,Delta,JFK,DEN,6,17,37,8,22,84
3005,Southwest,ORD,SEA,6,30,15,12,5,62
3006,JetBlue,ORD,SEA,23,11,13,6,28,58
3007,JetBlue,DFW,DEN,15,38,10,0,21,69
3008,American,JFK,SEA,13,48,49,10,23,130
3009,JetBlue,JFK,MIA,13,27,29,0,15,71
3010,JetBlue,DFW,MIA,8,17,38,2,29,86
3011,Delta,ORD,PHX,16,6,46,4,12,68
3012,JetBlue,JFK,MIA,21,54,53,6,7,120
3013,Delta,ATL,SEA,18,39,36,3,17,95
3014,American,DFW,SEA,21,39,53,7,21,120
3015,JetBlue,ORD,PHX,13,53,55,0,3,111
3016,United,ORD,PHX,9,20,14,10,27,71
3017,Southwest,LAX,BOS,8,22,51,5,12,90
3018,United,LAX,BOS,17,53,0,9,5,67
3019,Delta,ORD,DEN,4,46,29,6,21,102
3020,United,ATL,DEN,21,58,4,0,0,62
3021,JetBlue,LAX,PHX,13,22,58,7,24,111
3022,American,LAX,BOS,18,51,33,12,5,101
3023,JetBlue,ATL,DEN,8,9,53,2,6,70
3024,Southwest,ORD,SEA,11,28,32,1,28,89
3025,Southwest,JFK,PHX,19,6,0,0,15,21
3026,American,DFW,BOS,18,54,24,13,18,109
3027,American,DFW,PHX,22,28,13,11,25,77
3028,Delta,ATL,MIA,11,39,42,8,21,110
3029,Southwest,ORD,MIA,14,9,53,8,26,96
3030,American,ATL,PHX,15,23,31,13,9,76
3031,American,ATL,BOS,6,0,2,0,28,30
3032,United,JFK,MIA,21,0,10,7,5,22
3033,United,ATL,MIA,12,53,1,10,11,75
3034,Southwest,LAX,MIA,21,24,27,8,14,73
3035,Delta,LAX,SEA,15,40,25,1,18,84
3036,Southwest,DFW,BOS,2,19,44,8,8,79
3037,United,LAX,DEN,16,4,21,5,6,36
3038,Delta,JFK,BOS,16,21,3,6,12,42
3039,American,DFW,MIA,4,42,56,12,7,117
3040,Southwest,ATL,MIA,16,18,9,2,28,57
3041,American,ATL,PHX,2,55,56,9,7,127
3042,Southwest,ORD,DEN,4,54,4,8,13,79
3043,American,ORD,MIA,12,31,15,8,25,79
3044,American,DFW,MIA,12,43,24,13,11,91
3045,American,ATL,MIA,0,26,25,14,12,77
3046,Delta,DFW,PHX,18,42,14,6,11,73
3047,United,ATL,SEA,5,47,34,3,25,109
3048,JetBlue,DFW,DEN,17,4,38,8,15,65
3049,JetBlue,JFK,BOS,14,30,3,12,8,53
3050,United,ORD,DEN,13,50,45,11,4,110
3051,JetBlue,DFW,BOS,0,3,7,5,20,35
3052,American,ATL,MIA,6,20,37,7,11,75
3053,Delta,ATL,SEA,17,7,5,13,22,47
3054,Delta,DFW,BOS,17,3,8,13,27,51
3055,Southwest,ATL,DEN,5,18,27,1,25,71
3056,JetBlue,DFW,PHX,4,16,34,9,5,64
3057,United,LAX,BOS,2,12,18,1,7,38
3058,Delta,LAX,DEN,7,21,56,13,6,96
3059,United,ATL,DEN,17,29,40,4,19,92
3060,Delta,LAX,BOS,14,10,30,12,23,75
3061,United,ATL,DEN,17,2,51,6,4,63
3062,United,JFK,SEA,16,35,45,12,17,109
3063,American,JFK,DEN,16,34,53,0,0,87
3064,Southwest,JFK,SEA,1,2,48,8,13,71
3065,United,JFK,PHX,22,9,52,1,10,72
3066,United,ATL,SEA,14,33,23,1,27,84
3067,American,JFK,MIA,16,54,45,13,1,113
3068,American,DFW,DEN,4,41,29,5,22,97
3069,Delta,ATL,SEA,13,51,21,5,16,93
3070,Delta,LAX,PHX,13,31,47,8,16,102
3071,American,JFK,MIA,13,15,58,10,4,87
3072,Southwest,JFK,SEA,19,31,23,0,23,77
3073,JetBlue,DFW,PHX,22,25,31,7,18,81
3074,Delta,ATL,PHX,5,18,0,11,1,30
3075,JetBlue,ATL,SEA,11,6,12,7,19,44
3076,JetBlue,JFK,DEN,3,4,21,13,27,65
3077,American,ATL,MIA,9,58,51,1,22,132
3078,American,ORD,BOS,8,19,3,7,22,51
3079,Delta,JFK,MIA,8,40,48,7,28,123
3080,American,LAX,SEA,11,23,1,7,5,36
3081,Delta,LAX,DEN,0,50,21,8,3,82
3082,American,LAX,BOS,16,21,55,9,8,93
3083,JetBlue,ORD,PHX,3,57,1,13,29,100
3084,American,DFW,BOS,15,43,3,13,4,63
3085,American,DFW,BOS,14,16,40,7,25,88
3086,Southwest,DFW,SEA,7,35,5,11,9,60
3087,Delta,JFK,DEN,7,7,53,8,18,86
3088,JetBlue,DFW,MIA,12,3,53,12,18,86
3089,Delta,ATL,DEN,23,5,14,1,5,25
3090,JetBlue,JFK,SEA,23,48,28,13,6,95
3091,Southwest,JFK,PHX,3,1,40,10,6,57
3092,American,DFW,BOS,1,7,13,5,21,46
3093,United,ORD,MIA,10,19,55,12,5,91
3094,Southwest,ATL,SEA,10,14,57,4,14,89
3095,Delta,ORD,PHX,9,34,21,1,4,60
3096,United,ATL,PHX,2,11,24,5,21,61
3097,American,LAX,BOS,14,41,12,10,25,88
3098,Southwest,JFK,MIA,4,1,2,11,26,40
3099,American,LAX,DEN,16,54,45,12,18,129
3100,Southwest,LAX,SEA,21,8,41,6,29,84
3101,United,JFK,MIA,7,18,3,14,27,62
3102,JetBlue,ATL,SEA,15,24,6,9,15,54
3103,JetBlue,DFW,MIA,14,4,25,13,14,56
3104,Delta,DFW,PHX,13,42,18,12,5,77
3105,JetBlue,DFW,DEN,9,6,3,10,17,36
3106,American,LAX,SEA,5,23,52,2,21,98
3107,American,ATL,PHX,14,55,22,7,8,92
3108,Delta,DFW,MIA,2,42,26,7,12,87
3109,American,JFK,PHX,22,34,55,7,25,121
3110,Delta,LAX,BOS,20,29,30,11,21,91
3111,JetBlue,LAX,SEA,17,58,55,5,0,118
3112,JetBlue,ATL,BOS,12,6,8,12,27,53
3113,Southwest,DFW,DEN,2,54,12,4,7,77
3114,United,ORD,DEN,1,6,46,5,7,64
3115,JetBlue,DFW,BOS,10,19,18,3,19,59
3116,Delta,ORD,SEA,20,20,46,7,21,94
3117,American,LAX,SEA,17,57,17,8,27,109
3118,Southwest,JFK,BOS,21,16,26,13,2,57
3119,JetBlue,DFW,PHX,10,51,45,11,5,112
3120,Delta,DFW,SEA,18,2,55,7,22,86
3121,Delta,JFK,SEA,21,41,57,10,17,125
3122,United,ATL,DEN,14,40,2,9,28,79
3123,American,ORD,BOS,23,35,11,13,18,77
3124,JetBlue,ATL,DEN,18,54,41,6,4,105
3125,American,ORD,SEA,11,47,57,5,21,130
3126,United,LAX,PHX,10,55,3,11,5,74
3127,American,JFK,BOS,14,49,7,7,17,80
3128,JetBlue,ORD,BOS,13,27,24,12,0,63
3129,Delta,ATL,BOS,22,21,45,13,8,87
3130,United,ATL,PHX,16,54,24,7,12,97
3131,United,ATL,BOS,2,30,10,12,17,69
3132,American,DFW,PHX,16,40,44,11,12,107
3133,Southwest,JFK,BOS,13,14,47,12,20,93
3134,Southwest,ATL,MIA,7,40,11,0,16,67
3135,American,LAX,PHX,23,5,50,1,27,83
3136,Southwest,LAX,SEA,2,6,34,4,25,69
3137,American,ATL,DEN,23,10,23,6,26,65
3138,Southwest,JFK,PHX,17,8,14,12,22,56
3139,United,LAX,SEA,11,53,12,1,26,92
3140,Southwest,ORD,SEA,16,36,30,6,10,82
3141,Southwest,LAX,SEA,19,37,54,8,3,102
3142,Southwest,ORD,BOS,20,44,35,11,1,91
3143,Southwest,JFK,PHX,2,24,17,9,0,50
3144,American,ATL,MIA,23,10,39,14,20,83
3145,American,ATL,MIA,3,26,6,2,11,45
3146,Delta,DFW,PHX,11,3,34,3,28,68
3147,Southwest,JFK,PHX,11,44,19,2,29,94
3148,United,ORD,DEN,12,7,15,3,29,54
3149,United,JFK,PHX,21,33,32,14,19,98
3150,JetBlue,ORD,DEN,8,33,56,3,28,120
3151,American,JFK,PHX,16,0,31,9,13,53
3152,Southwest,DFW,BOS,4,23,9,5,7,44
3153,United,ORD,SEA,14,46,57,9,8,120
3154,JetBlue,ORD,DEN,14,49,23,5,10,87
3155,American,JFK,PHX,11,32,50,8,23,113
3156,American,JFK,BOS,1,50,39,4,21,114
3157,United,DFW,PHX,13,32,25,13,12,82
3158,United,ATL,PHX,21,52,0,6,25,83
3159,American,ORD,PHX,23,12,5,5,13,35
3160,Delta,ORD,DEN,8,7,0,2,23,32
3161,JetBlue,LAX,BOS,14,15,43,12,9,79
3162,American,DFW,PHX,6,39,19,13,3,74
3163,United,ATL,DEN,23,35,18,5,8,66
3164,United,ORD,SEA,7,35,37,1,17,90
3165,Southwest,DFW,DEN,10,56,32,10,23,121
3166,American,DFW,DEN,23,37,37,9,24,107
3167,JetBlue,ORD,BOS,16,53,50,9,17,129
3168,Delta,LAX,DEN,20,59,56,5,24,144
3169,Southwest,ORD,SEA,7,5,5,5,2,17
3170,Southwest,DFW,SEA,4,2,16,8,29,55
3171,JetBlue,ORD,SEA,23,16,31,5,3,55
3172,American,ORD,PHX,11,35,24,10,10,79
3173,Southwest,DFW,SEA,8,20,26,14,16,76
3174,JetBlue,ORD,BOS,1,28,6,13,17,64
3175,Southwest,ATL,DEN,6,22,9,11,19,61
3176,American,JFK,SEA,5,7,11,13,16,47
3177,Southwest,ORD,BOS,5,51,4,5,25,85
3178,Delta,JFK,BOS,6,33,47,10,20,110
3179,American,DFW,PHX,6,37,12,4,4,57
3180,JetBlue,JFK,MIA,0,46,10,9,10,75
3181,American,JFK,MIA,8,50,11,1,13,75
3182,American,ATL,SEA,17,46,59,2,5,112
3183,United,JFK,BOS,2,58,51,10,0,119
3184,United,ATL,DEN,22,28,32,12,25,97
3185,Delta,JFK,SEA,23,3,11,9,2,25
3186,Southwest,JFK,BOS,21,50,58,3,6,117
3187,United,ATL,MIA,15,31,43,12,19,105
3188,United,JFK,BOS,12,51,37,13,27,128
3189,Southwest,DFW,SEA,18,29,43,9,0,81
3190,American,JFK,MIA,7,4,4,6,16,30
3191,JetBlue,DFW,PHX,16,29,42,0,9,80
3192,United,ORD,PHX,8,8,56,0,6,70
3193,JetBlue,JFK,DEN,8,9,26,12,27,74
3194,Delta,ATL,MIA,13,34,8,11,17,70
3195,American,LAX,PHX,7,12,27,11,24,74
3196,Delta,DFW,BOS,2,1,49,11,20,81
3197,American,ATL,DEN,12,15,33,10,2,60
3198,United,LAX,SEA,16,59,14,7,20,100
3199,JetBlue,ATL,DEN,8,29,14,0,8,51
3200,Delta,ORD,SEA,6,51,20,1,26,98
3201,American,DFW,MIA,23,23,4,1,16,44
3202,United,ORD,MIA,19,43,17,10,18,88
3203,Delta,ATL,MIA,23,43,43,13,27,126
3204,Southwest,ORD,SEA,0,55,34,0,7,96
3205,American,ORD,DEN,20,55,9,3,29,96
3206,United,JFK,DEN,1,50,43,10,3,106
3207,Delta,ATL,DEN,13,32,33,0,26,91
3208,JetBlue,ATL,SEA,10,9,15,7,8,39
3209,American,JFK,PHX,20,8,0,7,15,30
3210,Southwest,DFW,BOS,13,59,42,11,18,130
3211,Southwest,ATL,PHX,21,19,10,11,29,69
3212,Southwest,DFW,PHX,14,13,59,2,8,82
3213,JetBlue,ATL,SEA,15,32,21,12,0,65
3214,United,DFW,DEN,5,57,8,10,24,99
3215,Delta,LAX,BOS,11,39,48,7,21,115
3216,Southwest,JFK,SEA,16,19,8,0,9,36
3217,JetBlue,JFK,SEA,2,52,29,13,14,108
3218,Southwest,LAX,BOS,14,12,55,8,29,104
3219,Delta,DFW,SEA,3,42,2,12,3,59
3220,United,ATL,BOS,9,41,5,10,26,82
3221,JetBlue,ORD,SEA,2,48,59,11,16,134
3222,Delta,JFK,BOS,17,20,9,1,9,39
3223,Southwest,DFW,BOS,7,40,30,0,0,70
3224,Delta,DFW,BOS,3,2,4,8,1,15
3225,United,ORD,PHX,4,46,33,14,2,95
3226,Delta,JFK,DEN,2,34,19,14,12,79
3227,Southwest,JFK,PHX,19,36,22,1,8,67
3228,Southwest,ATL,BOS,19,16,55,12,3,86
3229,United,ORD,DEN,4,42,57,13,1,113
3230,United,LAX,BOS,2,32,36,5,2,75
3231,United,ATL,SEA,5,58,11,8,19,96
3232,American,LAX,BOS,8,20,44,9,21,94
3233,American,DFW,DEN,21,51,9,14,16,90
3234,JetBlue,ATL,DEN,1,33,29,14,4,80
3235,American,LAX,SEA,7,6,38,1,14,59
3236,United,DFW,PHX,13,6,23,5,0,34
3237,JetBlue,JFK,SEA,18,49,19,6,26,100
3238,United,ORD,BOS,9,22,38,11,7,78
3239,Southwest,ATL,BOS,23,27,12,0,10,49
3240,American,DFW,PHX,13,7,5,0,18,30
3241,Delta,ORD,SEA,0,15,55,14,24,108
3242,Delta,ATL,PHX,23,56,25,10,29,120
3243,United,LAX,MIA,3,55,35,4,11,105
3244,United,ATL,DEN,14,22,9,0,22,53
3245,JetBlue,ORD,BOS,15,27,17,11,13,68
3246,American,ATL,MIA,13,10,58,7,25,100
3247,American,ORD,MIA,9,14,43,7,20,84
3248,Delta,ORD,DEN,21,13,8,0,18,39
3249,Delta,ORD,DEN,9,19,39,8,3,69
3250,JetBlue,ATL,MIA,13,20,47,8,21,96
3251,American,ORD,SEA,21,34,34,7,11,86
3252,Delta,LAX,PHX,6,40,52,13,19,124
3253,American,ATL,SEA,11,59,19,0,18,96
3254,American,LAX,BOS,21,42,16,11,11,80
3255,Delta,ORD,PHX,6,11,12,4,15,42
3256,United,LAX,PHX,8,53,36,4,13,106
3257,United,ORD,SEA,18,31,12,9,2,54
3258,American,DFW,BOS,1,25,11,11,17,64
3259,Delta,ATL,BOS,19,8,13,10,11,42
3260,JetBlue,JFK,BOS,6,4,0,13,28,45
3261,Delta,LAX,SEA,4,9,3,1,28,41
3262,Delta,ATL,SEA,19,36,17,6,19,78
3263,Southwest,JFK,PHX,8,6,37,10,4,57
3264,United,LAX,SEA,16,43,3,13,2,61
3265,American,DFW,BOS,23,44,46,0,1,91
3266,Delta,LAX,MIA,2,14,52,8,8,82
3267,Southwest,ORD,SEA,7,37,2,13,17,69
3268,JetBlue,ATL,PHX,16,38,54,13,12,117
3269,JetBlue,LAX,SEA,23,26,57,6,2,91
3270,Southwest,JFK,SEA,21,36,54,3,15,108
3271,United,ORD,MIA,15,9,26,1,2,38
3272,JetBlue,ORD,MIA,14,30,38,10,11,89
3273,Delta,ATL,BOS,10,51,47,3,29,130
3274,JetBlue,DFW,DEN,22,29,28,5,2,64
3275,United,ATL,BOS,1,32,26,12,16,86
3276,Southwest,JFK,MIA,19,9,23,13,28,73
3277,United,LAX,DEN,12,24,29,3,17,73
3278,Southwest,ATL,PHX,17,28,36,9,29,102
3279,American,LAX,DEN,14,56,45,0,18,119
3280,Delta,DFW,PHX,1,25,34,7,1,67
3281,United,DFW,MIA,20,34,8,11,3,56
3282,Delta,JFK,PHX,9,18,42,7,20,87
3283,JetBlue,ATL,MIA,15,49,33,6,7,95
3284,Southwest,JFK,PHX,20,37,2,9,13,61
3285,Southwest,LAX,PHX,0,13,50,8,5,76
3286,Delta,ORD,PHX,8,33,35,0,19,87
3287,American,ORD,DEN,9,16,33,4,20,73
3288,Delta,LAX,DEN,17,15,27,9,28,79
3289,United,ORD,BOS,17,2,44,5,12,63
3290,JetBlue,JFK,DEN,9,15,23,12,29,79
3291,Southwest,LAX,SEA,23,42,16,1,13,72
3292,United,ORD,SEA,8,44,48,6,6,104
3293,Southwest,ATL,BOS,14,38,46,10,10,104
3294,United,JFK,BOS,3,45,12,9,27,93
3295,Southwest,ATL,PHX,20,3,5,14,10,32
3296,American,ATL,DEN,12,27,33,9,20,89
3297,Delta,ORD,SEA,7,27,55,11,6,99
3298,American,JFK,SEA,13,22,38,14,19,93
3299,United,JFK,BOS,5,15,3,10,18,46
3300,American,LAX,MIA,2,45,38,1,25,109
3301,Delta,LAX,SEA,14,22,9,0,7,38
3302,JetBlue,DFW,SEA,22,3,30,4,13,50
3303,Southwest,DFW,SEA,0,55,43,3,23,124
3304,JetBlue,DFW,DEN,18,1,2,5,7,15
3305,Delta,DFW,DEN,6,34,51,10,24,119
3306,United,LAX,DEN,18,40,4,2,14,60
3307,JetBlue,ORD,MIA,14,26,25,1,16,68
3308,United,LAX,MIA,10,35,8,12,29,84
3309,JetBlue,LAX,SEA,13,27,14,4,16,61
3310,JetBlue,LAX,BOS,16,43,21,6,2,72
3311,United,JFK,BOS,18,42,1,10,7,60
3312,American,LAX,DEN,6,18,50,5,21,94
3313,United,LAX,PHX,0,50,4,11,24,89
3314,Delta,JFK,SEA,8,48,22,4,3,77
3315,American,ORD,DEN,20,14,47,4,13,78
3316,Delta,ORD,BOS,23,9,9,14,11,43
3317,United,JFK,DEN,4,38,14,6,22,80
3318,United,ATL,MIA,17,32,46,3,23,104
3319,American,JFK,PHX,22,24,12,12,20,68
3320,American,ORD,SEA,10,40,11,1,14,66
3321,American,DFW,PHX,4,22,30,2,0,54
3322,Delta,LAX,PHX,17,30,50,8,5,93
3323,JetBlue,DFW,BOS,2,53,51,4,17,125
3324,Delta,LAX,BOS,13,54,15,14,9,92
3325,JetBlue,ORD,DEN,12,23,1,3,13,40
3326,Southwest,DFW,BOS,7,16,2,12,9,39
3327,American,DFW,SEA,3,0,7,8,4,19
3328,Delta,ATL,DEN,15,33,27,2,14,76
3329,JetBlue,JFK,SEA,18,54,49,0,2,105
3330,Southwest,LAX,PHX,7,28,40,13,1,82
3331,JetBlue,ORD,MIA,19,29,43,1,14,87
3332,Southwest,LAX,SEA,23,12,54,12,5,83
3333,American,JFK,SEA,2,46,41,4,29,120
3334,Southwest,ATL,MIA,16,14,39,9,17,79
3335,JetBlue,DFW,PHX,13,38,34,9,5,86
3336,Southwest,ATL,SEA,11,3,43,5,5,56
3337,Southwest,DFW,DEN,16,29,23,7,9,68
3338,American,LAX,MIA,18,33,1,10,5,49
3339,Delta,JFK,DEN,15,1,49,2,26,78
3340,American,DFW,MIA,23,23,0,13,16,52
3341,American,DFW,DEN,19,51,19,0,9,79
3342,Delta,ORD,BOS,11,3,20,14,29,66
3343,Southwest,ORD,PHX,0,48,0,13,27,88
3344,American,LAX,BOS,17,30,3,1,11,45
3345,Delta,LAX,SEA,5,30,17,12,9,68
3346,American,DFW,DEN,14,13,31,7,19,70
3347,American,DFW,BOS,2,15,19,3,10,47
3348,Southwest,DFW,MIA,18,58,45,10,5,118
3349,American,ORD,PHX,1,11,19,9,2,41
3350,Delta,ATL,PHX,22,25,16,4,28,73
3351,United,ATL,DEN,16,34,48,5,14,101
3352,United,DFW,MIA,12,43,8,3,12,66
3353,American,LAX,DEN,8,15,42,6,27,90
3354,Southwest,ORD,PHX,18,15,11,2,5,33
3355,American,LAX,MIA,16,0,37,13,3,53
3356,Delta,DFW,MIA,2,53,17,9,4,83
3357,JetBlue,ORD,BOS,15,15,5,13,18,51
3358,Delta,DFW,PHX,0,11,22,4,15,52
3359,United,LAX,DEN,9,13,41,10,1,65
3360,United,JFK,SEA,3,52,32,9,3,96
3361,American,JFK,PHX,20,47,9,8,25,89
3362,Delta,ATL,PHX,4,44,56,12,20,132
3363,Delta,LAX,SEA,0,9,18,0,8,35
3364,JetBlue,ATL,SEA,4,0,43,4,25,72
3365,Delta,ORD,SEA,6,33,10,5,14,62
3366,JetBlue,ATL,DEN,3,16,43,7,12,78
3367,Southwest,DFW,SEA,19,18,37,2,23,80
3368,JetBlue,LAX,MIA,11,23,38,11,11,83
3369,JetBlue,JFK,SEA,19,3,46,0,26,75
3370,Delta,LAX,DEN,9,55,8,7,9,79
3371,JetBlue,ATL,BOS,12,22,53,13,23,111
3372,Southwest,LAX,BOS,15,49,44,9,14,116
3373,American,ATL,DEN,2,12,0,13,28,53
3374,Delta,DFW,DEN,20,25,56,4,5,90
3375,JetBlue,ORD,BOS,2,48,34,14,0,96
3376,United,ATL,BOS,16,51,39,5,22,117
3377,Delta,ATL,PHX,12,17,9,7,16,49
3378,United,LAX,MIA,6,31,10,13,13,67
3379,JetBlue,ORD,MIA,1,26,59,8,25,118
3380,American,JFK,MIA,22,16,12,3,7,38
3381,American,DFW,BOS,16,31,28,11,12,82
3382,American,JFK,PHX,10,16,13,10,0,39
3383,JetBlue,LAX,BOS,14,28,12,13,26,79
3384,American,LAX,BOS,16,29,20,13,22,84
3385,Delta,ORD,SEA,7,13,27,6,13,59
3386,JetBlue,JFK,PHX,10,55,33,12,1,101
3387,Delta,ORD,DEN,15,59,48,3,3,113
3388,American,LAX,SEA,3,15,58,5,6,84
3389,United,ATL,SEA,10,9,56,13,6,84
3390,Delta,ORD,DEN,14,56,45,6,23,130
3391,American,ATL,DEN,12,34,28,10,1,73
3392,United,LAX,SEA,7,16,29,11,12,68
3393,Delta,DFW,DEN,14,52,29,0,2,83
3394,Southwest,JFK,MIA,11,31,11,11,20,73
3395,United,JFK,DEN,18,23,3,6,7,39
3396,JetBlue,LAX,PHX,0,59,14,5,2,80
3397,Delta,ORD,PHX,0,15,32,14,20,81
3398,Southwest,DFW,PHX,15,9,17,7,21,54
3399,United,JFK,BOS,23,39,59,9,4,111
3400,Southwest,LAX,DEN,5,30,3,7,0,40
3401,Southwest,ATL,BOS,0,43,54,12,15,124
3402,American,ORD,PHX,12,42,47,11,18,118
3403,United,LAX,MIA,23,9,13,6,28,56
3404,United,ORD,SEA,19,31,50,10,14,105
3405,Delta,LAX,MIA,13,50,55,11,10,126
3406,JetBlue,ATL,DEN,14,7,56,1,1,65
3407,Delta,JFK,PHX,11,42,51,7,1,101
3408,Delta,LAX,BOS,2,1,43,12,27,83
3409,JetBlue,ATL,BOS,19,14,51,8,16,89
3410,Southwest,ORD,PHX,17,4,26,7,22,59
3411,JetBlue,ATL,DEN,9,43,51,7,14,115
3412,American,JFK,DEN,4,38,30,1,14,83
3413,Southwest,ORD,BOS,19,56,18,7,6,87
3414,JetBlue,LAX,DEN,5,38,28,9,1,76
3415,American,DFW,PHX,11,46,30,2,25,103
3416,Southwest,DFW,DEN,16,5,54,5,20,84
3417,JetBlue,DFW,PHX,4,18,46,13,17,94
3418,United,ORD,MIA,10,53,23,8,22,106
3419,JetBlue,DFW,SEA,17,51,1,10,1,63
3420,Southwest,JFK,PHX,16,27,21,7,2,57
3421,Southwest,LAX,PHX,1,0,22,11,15,48
3422,American,DFW,MIA,5,22,40,11,15,88
3423,United,LAX,PHX,9,55,16,9,25,105
3424,Delta,LAX,SEA,9,26,40,9,7,82
3425,Delta,LAX,SEA,23,15,9,7,13,44
3426,JetBlue,DFW,SEA,19,13,11,3,22,49
3427,United,LAX,DEN,16,27,35,3,17,82
3428,American,ORD,MIA,19,5,9,14,1,29
3429,JetBlue,ATL,SEA,20,23,26,6,17,72
3430,American,ATL,SEA,9,58,50,1,15,124
3431,JetBlue,ORD,DEN,11,7,26,3,2,38
3432,Delta,ATL,BOS,0,0,55,14,21,90
3433,Southwest,DFW,BOS,3,13,19,11,2,45
3434,Delta,ATL,DEN,9,55,11,2,7,75
3435,JetBlue,JFK,MIA,20,21,21,14,27,83
3436,United,LAX,DEN,5,7,52,0,14,73
3437,American,JFK,BOS,13,28,37,1,0,66
3438,Southwest,ORD,BOS,15,57,31,14,11,113
3439,Southwest,DFW,MIA,11,3,38,7,18,66
3440,Delta,DFW,PHX,13,0,32,6,6,44
3441,Delta,LAX,MIA,9,5,43,7,17,72
3442,JetBlue,JFK,DEN,10,56,21,4,28,109
3443,United,ATL,MIA,22,35,23,0,7,65
3444,Delta,ATL,PHX,0,44,57,13,4,118
3445,United,ATL,MIA,20,52,2,4,0,58
3446,Delta,LAX,SEA,19,34,3,4,6,47
3447,JetBlue,ATL,MIA,15,54,34,4,27,119
3448,JetBlue,ORD,SEA,13,50,57,12,22,141
3449,JetBlue,ORD,DEN,11,25,36,5,25,91
3450,United,LAX,MIA,15,58,10,7,18,93
3451,United,ORD,BOS,22,52,40,6,22,120
3452,JetBlue,ATL,SEA,3,44,54,8,2,108
3453,United,ORD,SEA,15,9,16,2,4,31
3454,Southwest,ATL,SEA,10,45,57,4,22,128
3455,Delta,ATL,SEA,9,58,18,6,14,96
3456,Delta,DFW,BOS,5,7,12,3,29,51
3457,Delta,ORD,BOS,7,22,12,1,21,56
3458,Delta,DFW,SEA,20,46,27,11,3,87
3459,American,JFK,PHX,23,26,21,14,20,81
3460,Southwest,DFW,SEA,2,22,42,6,8,78
3461,United,ATL,PHX,0,24,0,6,16,46
3462,Southwest,ORD,DEN,4,25,12,7,10,54
3463,JetBlue,ORD,PHX,10,33,53,9,2,97
3464,United,LAX,DEN,21,27,25,2,3,57
3465,Southwest,LAX,DEN,2,9,29,13,19,70
3466,JetBlue,DFW,MIA,5,5,15,13,0,33
3467,American,LAX,DEN,19,35,17,9,29,90
3468,Delta,DFW,SEA,3,5,40,3,3,51
3469,American,DFW,BOS,23,44,6,0,24,74
3470,American,ATL,BOS,5,30,7,9,28,74
3471,United,ORD,MIA,6,14,16,8,18,56
3472,Southwest,ORD,BOS,0,17,39,11,2,69
3473,United,ORD,MIA,5,36,1,10,5,52
3474,Delta,ORD,SEA,22,45,38,12,25,120
3475,Southwest,LAX,PHX,10,24,3,1,3,31
3476,JetBlue,DFW,DEN,20,57,42,7,25,131
3477,JetBlue,ATL,MIA,21,6,7,13,28,54
3478,Delta,DFW,PHX,14,39,33,12,4,88
3479,American,ATL,BOS,21,55,8,4,16,83
3480,Delta,ATL,MIA,5,3,17,1,20,41
3481,Southwest,JFK,DEN,1,24,40,8,5,77
3482,United,ORD,PHX,6,17,25,9,19,70
3483,United,DFW,MIA,1,25,0,10,7,42
3484,United,JFK,DEN,2,54,10,12,10,86
3485,JetBlue,LAX,SEA,15,3,22,0,16,41
3486,Delta,JFK,PHX,1,8,35,2,14,59
3487,JetBlue,JFK,BOS,16,25,30,11,26,92
3488,American,ATL,PHX,9,40,7,0,15,62
3489,Southwest,ORD,SEA,22,56,15,2,15,88
3490,American,DFW,DEN,1,46,26,9,15,96
3491,Delta,DFW,BOS,12,32,9,0,2,43
3492,Delta,LAX,SEA,14,30,38,3,5,76
3493,United,LAX,SEA,17,31,0,4,16,51
3494,Delta,ATL,DEN,15,9,16,2,4,31
3495,Delta,ORD,PHX,5,39,35,7,26,107
3496,Delta,LAX,SEA,6,35,22,0,27,84
3497,Southwest,DFW,SEA,13,18,5,6,12,41
3498,United,ATL,DEN,21,29,29,12,2,72
3499,United,JFK,MIA,6,5,25,12,5,47
3500,JetBlue,DFW,SEA,16,53,4,14,26,97
3501,JetBlue,LAX,SEA,16,9,39,0,15,63
3502,United,LAX,BOS,14,30,46,6,28,110
3503,JetBlue,JFK,SEA,13,23,13,0,26,62
3504,Delta,ATL,BOS,19,17,31,2,9,59
3505,JetBlue,LAX,SEA,10,26,49,2,13,90
3506,Southwest,LAX,MIA,11,27,5,6,29,67
3507,United,DFW,PHX,20,31,6,0,24,61
3508,JetBlue,LAX,PHX,16,10,1,2,6,19
3509,American,LAX,MIA,12,6,56,1,29,92
3510,United,ATL,PHX,11,21,17,4,25,67
3511,JetBlue,ORD,SEA,9,34,33,4,1,72
3512,Southwest,ORD,MIA,3,1,13,4,5,23
3513,American,JFK,DEN,2,12,51,2,14,79
3514,Southwest,ORD,PHX,21,33,0,13,12,58
3515,Southwest,ATL,PHX,2,23,3,11,27,64
3516,JetBlue,ATL,SEA,10,34,14,6,28,82
3517,JetBlue,ORD,SEA,10,4,50,5,23,82
3518,American,ORD,PHX,0,27,55,11,21,114
3519,JetBlue,LAX,MIA,8,3,54,13,24,94
3520,United,DFW,DEN,6,59,49,12,7,127
3521,Southwest,ORD,BOS,16,48,33,10,6,97
3522,Southwest,JFK,DEN,22,38,4,5,1,48
3523,Southwest,JFK,BOS,17,54,21,2,25,102
3524,United,JFK,MIA,21,51,59,7,27,144
3525,United,JFK,SEA,16,43,22,8,16,89
3526,Delta,DFW,PHX,14,38,10,8,17,73
3527,Delta,LAX,BOS,17,0,23,3,19,45
3528,American,DFW,SEA,0,48,28,2,19,97
3529,Delta,ATL,BOS,20,23,20,8,13,64
3530,Southwest,JFK,PHX,22,20,58,2,26,106
3531,American,JFK,DEN,12,40,45,8,9,102
3532,United,JFK,PHX,2,6,11,13,21,51
3533,Southwest,ATL,BOS,11,20,48,7,25,100
3534,Delta,JFK,MIA,14,23,15,3,21,62
3535,United,DFW,SEA,19,34,18,8,7,67
3536,JetBlue,ATL,DEN,17,10,22,13,21,66
3537,American,ORD,SEA,2,37,22,1,6,66
3538,Delta,DFW,PHX,16,4,32,13,18,67
3539,Delta,LAX,DEN,0,57,9,5,13,84
3540,Southwest,JFK,BOS,22,9,58,12,16,95
3541,United,JFK,MIA,20,43,0,7,15,65
3542,JetBlue,LAX,DEN,20,5,33,4,28,70
3543,United,JFK,SEA,9,19,12,2,23,56
3544,United,JFK,SEA,17,32,39,12,3,86
3545,Southwest,DFW,DEN,2,41,51,8,8,108
3546,Southwest,DFW,PHX,9,38,2,13,27,80
3547,Southwest,LAX,BOS,15,42,41,0,20,103
3548,United,ATL,PHX,2,33,39,0,18,90
3549,United,DFW,DEN,11,1,52,14,12,79
3550,Southwest,ORD,DEN,14,58,16,4,26,104
3551,Delta,LAX,DEN,15,15,24,5,17,61
3552,United,JFK,DEN,18,6,34,2,0,42
3553,Delta,LAX,PHX,1,21,52,13,21,107
3554,JetBlue,DFW,SEA,22,57,44,4,21,126
3555,JetBlue,ATL,DEN,23,25,8,2,23,58
3556,United,DFW,BOS,22,23,40,13,12,88
3557,American,DFW,SEA,14,12,22,3,2,39
3558,Delta,DFW,DEN,17,46,58,0,19,123
3559,Southwest,JFK,DEN,13,52,56,14,1,123
3560,Southwest,DFW,MIA,4,29,39,9,15,92
3561,American,DFW,PHX,12,26,12,14,16,68
3562,American,DFW,MIA,9,38,47,10,7,102
3563,Southwest,ORD,MIA,14,5,57,7,8,77
3564,Delta,JFK,SEA,19,54,43,7,11,115
3565,Delta,ORD,SEA,11,25,50,7,20,102
3566,American,DFW,DEN,18,40,9,14,23,86
3567,Delta,ATL,DEN,12,26,18,6,29,79
3568,JetBlue,ATL,BOS,4,15,8,5,29,57
3569,American,ORD,BOS,6,26,7,0,28,61
3570,American,JFK,BOS,23,56,26,12,26,120
3571,Delta,ATL,BOS,18,14,51,14,14,93
3572,Delta,LAX,BOS,8,18,5,6,13,42
3573,American,DFW,MIA,6,59,19,1,16,95
3574,United,DFW,PHX,18,5,52,9,9,75
3575,Southwest,ORD,BOS,21,41,40,0,1,82
3576,United,ORD,BOS,2,42,37,0,5,84
3577,United,DFW,BOS,21,19,34,8,26,87
3578,Southwest,LAX,PHX,1,33,11,8,29,81
3579,American,LAX,DEN,13,27,34,8,17,86
3580,American,ORD,SEA,15,9,8,13,6,36
3581,American,ORD,BOS,17,3,56,4,16,79
3582,American,ORD,DEN,0,28,19,3,6,56
3583,JetBlue,ATL,DEN,12,34,7,1,10,52
3584,American,DFW,PHX,9,26,59,11,3,99
3585,Delta,LAX,MIA,23,24,34,11,14,83
3586,American,ATL,SEA,8,1,6,12,21,40
3587,American,DFW,PHX,19,2,44,3,1,50
3588,Delta,LAX,PHX,15,38,45,13,7,103
3589,American,JFK,SEA,1,8,57,7,24,96
3590,Southwest,LAX,DEN,2,0,46,10,1,57
3591,Delta,LAX,SEA,17,36,1,11,14,62
3592,American,DFW,MIA,3,0,7,14,17,38
3593,Southwest,ATL,PHX,9,57,46,12,25,140
3594,JetBlue,LAX,DEN,19,27,56,9,25,117
3595,Southwest,DFW,BOS,8,40,43,3,1,87
3596,JetBlue,ATL,DEN,6,43,38,6,17,104
3597,Southwest,ORD,SEA,20,33,12,13,16,74
3598,JetBlue,ORD,DEN,0,32,40,3,29,104
3599,Delta,LAX,BOS,12,24,46,7,17,94
3600,JetBlue,JFK,SEA,19,15,22,6,22,65
3601,American,ATL,BOS,23,44,5,12,11,72
3602,American,ORD,DEN,13,12,57,3,9,81
3603,Delta,JFK,PHX,13,22,42,7,2,73
3604,JetBlue,ATL,BOS,12,59,49,3,0,111
3605,United,ATL,DEN,22,56,29,9,23,117
3606,Delta,DFW,PHX,2,14,37,14,13,78
3607,United,DFW,SEA,8,37,14,2,12,65
3608,Southwest,DFW,SEA,12,33,51,1,23,108
3609,United,ORD,SEA,15,38,7,10,29,84
3610,Southwest,LAX,SEA,3,52,15,6,27,100
3611,Delta,LAX,DEN,17,4,23,8,21,56
3612,Delta,JFK,BOS,0,14,4,12,15,45
3613,Southwest,LAX,MIA,20,54,11,1,5,71
3614,Southwest,ATL,BOS,4,31,56,7,6,100
3615,JetBlue,ORD,PHX,6,59,6,0,27,92
3616,United,DFW,BOS,18,15,28,7,21,71
3617,American,DFW,SEA,17,59,0,6,22,87
3618,American,DFW,MIA,11,53,34,14,5,106
3619,JetBlue,ORD,DEN,3,52,47,14,27,140
3620,Southwest,JFK,MIA,7,32,33,11,5,81
3621,American,DFW,BOS,19,10,37,12,1,60
3622,Southwest,ORD,BOS,2,52,5,11,18,86
3623,JetBlue,ATL,DEN,23,58,23,8,19,108
3624,United,ORD,PHX,16,15,30,10,9,64
3625,Delta,LAX,BOS,18,7,59,2,15,83
3626,JetBlue,ATL,BOS,21,12,42,12,10,76
3627,United,ATL,MIA,18,26,53,10,14,103
3628,JetBlue,JFK,MIA,15,15,44,10,6,75
3629,United,LAX,DEN,19,32,41,5,0,78
3630,JetBlue,ATL,MIA,16,14,50,12,20,96
3631,American,ATL,PHX,2,54,35,5,7,101
3632,United,DFW,SEA,22,25,25,0,15,65
3633,American,JFK,BOS,10,22,56,3,0,81
3634,JetBlue,ORD,BOS,11,5,11,11,21,48
3635,Southwest,JFK,BOS,8,39,1,5,19,64
3636,United,JFK,PHX,20,57,12,1,16,86
3637,JetBlue,ORD,BOS,14,51,52,9,26,138
3638,American,ATL,BOS,0,45,18,3,16,82
3639,United,ATL,BOS,11,47,9,9,26,91
3640,American,ORD,MIA,4,4,37,8,22,71
3641,Southwest,JFK,MIA,7,27,3,2,5,37
3642,JetBlue,DFW,MIA,23,30,36,6,23,95
3643,Delta,DFW,PHX,10,43,13,0,29,85
3644,Delta,ATL,PHX,19,11,59,6,20,96
3645,United,ORD,MIA,5,58,28,8,24,118
3646,Southwest,ATL,MIA,17,2,20,11,7,40
3647,Southwest,LAX,DEN,4,2,42,9,23,76
3648,JetBlue,LAX,PHX,19,30,26,8,12,76
3649,American,DFW,PHX,9,3,35,13,20,71
3650,JetBlue,JFK,PHX,16,32,51,8,20,111
3651,Delta,LAX,DEN,17,9,7,13,15,44
3652,JetBlue,JFK,DEN,4,25,23,13,17,78
3653,Delta,DFW,SEA,16,47,39,7,22,115
3654,JetBlue,LAX,BOS,21,27,38,2,0,67
3655,United,ORD,MIA,21,33,28,4,19,84
3656,Delta,ATL,MIA,9,13,43,4,13,73
3657,United,JFK,MIA,18,53,15,14,2,84
3658,JetBlue,ORD,MIA,19,8,52,8,21,89
3659,JetBlue,DFW,DEN,12,1,10,3,4,18
3660,Southwest,JFK,MIA,22,17,24,7,7,55
3661,Delta,ORD,BOS,11,59,50,10,28,147
3662,American,ORD,PHX,11,26,20,1,18,65
3663,American,DFW,DEN,16,25,59,1,6,91
3664,American,LAX,BOS,12,52,55,1,24,132
3665,United,ORD,PHX,18,15,45,5,26,91
3666,American,ATL,PHX,12,58,20,11,11,100
3667,United,ATL,SEA,13,12,2,8,11,33
3668,Southwest,DFW,BOS,5,24,16,4,3,47
3669,United,ORD,BOS,10,6,7,3,8,24
3670,United,JFK,PHX,5,38,33,2,18,91
3671,JetBlue,DFW,DEN,10,11,43,4,24,82
3672,United,ATL,SEA,10,55,26,14,13,108
3673,Southwest,DFW,DEN,4,51,24,2,0,77
3674,United,LAX,PHX,3,54,37,2,27,120
3675,United,ATL,PHX,18,59,13,10,18,100
3676,United,ORD,MIA,23,19,46,6,8,79
3677,Southwest,JFK,PHX,18,54,37,13,0,104
3678,Southwest,ATL,MIA,10,27,34,10,28,99
3679,Southwest,LAX,SEA,18,15,57,7,8,87
3680,American,ORD,BOS,8,33,45,8,29,115
3681,American,DFW,PHX,9,10,46,2,0,58
3682,Delta,ATL,BOS,20,22,3,3,21,49
3683,Southwest,ATL,BOS,19,13,44,1,26,84
3684,Southwest,DFW,BOS,13,52,4,0,21,77
3685,American,DFW,BOS,22,29,1,1,29,60
3686,American,ATL,BOS,3,32,4,7,17,60
3687,Delta,DFW,PHX,10,30,16,0,29,75
3688,Delta,ORD,SEA,4,13,28,13,20,74
3689,American,ATL,PHX,5,58,45,4,6,113
3690,Delta,LAX,SEA,7,47,55,8,26,136
3691,Southwest,DFW,DEN,3,1,8,13,27,49
3692,United,LAX,PHX,16,27,34,3,22,86
3693,United,ATL,MIA,9,0,18,8,3,29
3694,American,JFK,MIA,3,39,28,12,8,87
3695,United,JFK,BOS,7,27,30,2,14,73
3696,United,LAX,DEN,0,57,11,12,12,92
3697,United,JFK,DEN,15,9,51,7,4,71
3698,United,JFK,PHX,0,35,39,9,15,98
3699,United,ORD,BOS,22,25,5,2,7,39
3700,American,ORD,BOS,14,19,45,14,20,98
3701,Delta,DFW,BOS,7,53,2,8,22,85
3702,Southwest,JFK,DEN,21,28,32,5,11,76
3703,American,ORD,PHX,5,56,31,0,23,110
3704,JetBlue,LAX,SEA,18,59,16,12,12,99
3705,American,JFK,MIA,3,38,49,10,7,104
3706,JetBlue,LAX,SEA,12,16,25,14,21,76
3707,Southwest,LAX,PHX,17,38,29,13,17,97
3708,JetBlue,LAX,MIA,17,22,17,7,22,68
3709,Southwest,ORD,PHX,9,21,45,12,1,79
3710,JetBlue,ORD,BOS,3,37,59,6,12,114
3711,Southwest,LAX,MIA,11,56,15,14,11,96
3712,United,DFW,SEA,20,2,29,10,24,65
3713,Delta,ORD,SEA,1,31,30,5,4,70
3714,American,JFK,BOS,20,37,17,10,4,68
3715,American,JFK,PHX,8,49,6,3,0,58
3716,JetBlue,DFW,PHX,14,9,56,11,23,99
3717,Southwest,DFW,DEN,12,28,25,10,5,68
3718,United,ATL,DEN,0,44,26,7,26,103
3719,American,JFK,MIA,6,42,59,4,13,118
3720,Southwest,LAX,DEN,16,18,38,9,10,75
3721,Delta,ATL,MIA,10,17,48,9,17,91
3722,Southwest,ATL,BOS,7,52,35,12,21,120
3723,United,DFW,SEA,9,20,29,2,13,64
3724,Delta,JFK,SEA,18,25,46,6,8,85
3725,Delta,ORD,SEA,15,15,43,2,18,78
3726,Delta,JFK,MIA,7,15,1,14,7,37
3727,United,DFW,SEA,17,48,20,6,17,91
3728,United,ATL,SEA,19,23,58,10,9,100
3729,American,DFW,SEA,12,58,29,13,16,116
3730,American,DFW,SEA,15,39,9,12,2,62
3731,American,DFW,MIA,14,44,56,9,18,127
3732,American,JFK,SEA,0,28,41,11,3,83
3733,Southwest,ORD,PHX,19,54,10,3,29,96
3734,American,DFW,MIA,17,1,8,4,18,31
3735,Southwest,LAX,PHX,13,49,17,9,12,87
3736,Southwest,ORD,SEA,11,36,57,4,24,121
3737,JetBlue,ORD,PHX,7,47,31,7,17,102
3738,American,DFW,DEN,3,51,53,9,13,126
3739,United,ATL,SEA,2,11,8,5,21,45
3740,JetBlue,JFK,MIA,14,42,12,8,22,84
3741,JetBlue,JFK,SEA,4,11,14,2,26,53
3742,JetBlue,ORD,SEA,20,23,32,2,4,61
3743,American,DFW,DEN,22,29,43,8,18,98
3744,American,LAX,PHX,15,15,28,8,27,78
3745,United,ATL,BOS,10,26,2,10,4,42
3746,American,DFW,MIA,13,27,4,5,11,47
3747,JetBlue,ORD,SEA,19,29,2,4,0,35
3748,American,ATL,SEA,13,46,35,9,23,113
3749,American,JFK,BOS,16,3,10,3,14,30
3750,Delta,ATL,PHX,12,18,15,8,18,59
3751,American,LAX,MIA,21,45,49,9,6,109
3752,JetBlue,LAX,PHX,6,19,18,13,0,50
3753,United,DFW,PHX,2,0,3,12,25,40
3754,Southwest,ORD,MIA,1,2,44,4,12,62
3755,American,DFW,DEN,1,24,21,11,6,62
3756,Delta,ATL,DEN,14,29,17,8,21,75
3757,American,ORD,PHX,21,45,19,13,17,94
3758,United,JFK,PHX,15,23,10,0,15,48
3759,JetBlue,JFK,BOS,5,19,29,6,11,65
3760,American,ORD,MIA,19,23,27,2,3,55
3761,United,JFK,DEN,9,14,7,4,2,27
3762,Delta,DFW,MIA,20,26,50,12,4,92
3763,Delta,ATL,MIA,21,47,52,11,8,118
3764,Southwest,LAX,BOS,21,39,27,8,0,74
3765,JetBlue,DFW,DEN,23,59,18,9,16,102
3766,JetBlue,ORD,MIA,2,33,40,1,4,78
3767,JetBlue,DFW,MIA,18,58,0,8,20,86
3768,American,ORD,BOS,11,57,55,14,3,129
3769,Southwest,JFK,DEN,3,18,59,8,13,98
3770,United,ATL,SEA,21,26,16,12,1,55
3771,Southwest,LAX,PHX,20,36,17,14,7,74
3772,JetBlue,ORD,SEA,23,1,23,2,3,29
3773,Southwest,LAX,PHX,0,38,55,2,10,105
3774,American,DFW,SEA,14,23,26,2,18,69
3775,JetBlue,ATL,SEA,21,21,32,4,7,64
3776,United,ATL,PHX,9,53,3,11,26,93
3777,JetBlue,ORD,DEN,21,11,34,6,25,76
3778,United,DFW,DEN,22,0,0,0,28,28
3779,American,DFW,MIA,11,6,13,0,17,36
3780,United,DFW,BOS,1,30,58,7,22,117
3781,JetBlue,DFW,SEA,16,13,15,2,28,58
3782,Southwest,ATL,PHX,12,7,25,12,16,60
3783,Delta,JFK,BOS,21,38,18,2,26,84
3784,American,ORD,PHX,20,17,47,11,18,93
3785,American,ORD,DEN,4,42,32,11,29,114
3786,JetBlue,LAX,SEA,9,36,48,1,3,88
3787,American,ORD,SEA,1,19,25,12,18,74
3788,JetBlue,LAX,SEA,17,54,42,7,26,129
3789,United,DFW,BOS,22,30,51,12,7,100
3790,American,DFW,BOS,20,9,29,9,28,75
3791,United,JFK,BOS,1,22,32,10,4,68
3792,Southwest,JFK,MIA,7,41,13,3,12,69
3793,JetBlue,DFW,DEN,13,28,41,9,20,98
3794,American,ORD,PHX,20,55,27,14,11,107
3795,Southwest,JFK,PHX,13,59,40,1,5,105
3796,Southwest,ATL,PHX,23,25,55,7,2,89
3797,JetBlue,ORD,BOS,11,33,17,13,0,63
3798,United,LAX,SEA,10,8,9,10,25,52
3799,Southwest,ORD,MIA,14,21,27,12,11,71
3800,American,LAX,PHX,1,3,47,5,19,74
3801,American,LAX,MIA,12,41,35,2,22,100
3802,JetBlue,JFK,DEN,23,59,53,14,0,126
3803,United,LAX,DEN,19,13,30,9,20,72
3804,Southwest,JFK,DEN,13,41,5,3,24,73
3805,Southwest,LAX,DEN,6,4,7,12,1,24
3806,American,ATL,SEA,14,55,55,0,6,116
3807,Southwest,DFW,PHX,12,4,18,9,16,47
3808,JetBlue,ATL,SEA,20,37,36,11,11,95
3809,United,ATL,PHX,11,0,49,12,28,89
3810,Southwest,DFW,SEA,3,8,18,6,13,45
3811,American,JFK,PHX,23,18,24,7,3,52
3812,Southwest,ORD,SEA,17,11,19,0,2,32
3813,Southwest,LAX,DEN,0,44,59,8,14,125
3814,JetBlue,DFW,DEN,9,33,29,5,24,91
3815,Delta,LAX,BOS,7,56,14,7,14,91
3816,Delta,JFK,MIA,1,28,0,0,21,49
3817,Delta,DFW,MIA,9,18,55,5,25,103
3818,American,DFW,PHX,20,7,56,10,1,74
3819,American,JFK,DEN,23,58,2,14,12,86
3820,Southwest,LAX,MIA,19,57,47,12,6,122
3821,Delta,ATL,PHX,12,33,7,8,15,63
3822,Southwest,LAX,MIA,6,12,44,11,14,81
3823,United,ORD,MIA,0,39,47,2,25,113
3824,United,LAX,BOS,1,44,48,9,7,108
3825,United,DFW,MIA,5,5,12,4,22,43
3826,American,DFW,SEA,12,46,37,7,17,107
3827,Delta,DFW,BOS,3,5,48,9,4,66
3828,Delta,LAX,MIA,17,46,7,0,8,61
3829,Southwest,LAX,BOS,1,56,34,12,29,131
3830,Delta,JFK,BOS,5,24,0,0,1,25
3831,American,DFW,BOS,8,19,55,13,5,92
3832,JetBlue,ATL,BOS,7,2,28,6,11,47
3833,Southwest,JFK,DEN,21,30,15,9,25,79
3834,Delta,LAX,BOS,20,17,12,4,6,39
3835,Southwest,ATL,SEA,6,47,8,3,2,60
3836,United,ORD,PHX,14,21,38,7,10,76
3837,United,JFK,DEN,0,49,2,13,16,80
3838,Southwest,ATL,BOS,20,49,14,10,15,88
3839,JetBlue,ORD,SEA,20,3,2,4,0,9
3840,United,ATL,BOS,0,46,22,2,21,91
3841,Delta,LAX,DEN,9,6,10,6,1,23
3842,United,ORD,DEN,5,28,41,14,8,91
3843,Southwest,ATL,BOS,2,54,34,9,16,113
3844,Delta,ATL,DEN,13,55,52,14,20,141
3845,Southwest,ORD,MIA,3,11,42,7,17,77
3846,American,JFK,DEN,21,30,44,8,10,92
3847,JetBlue,DFW,PHX,7,14,20,14,20,68
3848,United,ATL,PHX,16,7,7,9,23,46
3849,Southwest,DFW,PHX,10,47,2,2,29,80
3850,American,ATL,SEA,16,2,29,5,13,49
3851,United,ATL,SEA,2,22,36,9,29,96
3852,Delta,LAX,MIA,2,42,26,2,20,90
3853,JetBlue,LAX,MIA,0,30,39,1,16,86
3854,JetBlue,DFW,PHX,4,42,33,8,19,102
3855,JetBlue,ATL,MIA,21,51,7,9,11,78
3856,United,DFW,MIA,20,55,40,13,1,109
3857,JetBlue,DFW,SEA,23,11,17,7,28,63
3858,Delta,ORD,SEA,18,40,15,8,25,88
3859,JetBlue,LAX,DEN,2,35,9,1,23,68
3860,United,ATL,PHX,8,17,40,7,29,93
3861,JetBlue,ATL,SEA,19,2,11,6,9,28
3862,Southwest,DFW,MIA,21,8,23,3,24,58
3863,United,ORD,SEA,4,47,51,1,29,128
3864,JetBlue,DFW,DEN,12,23,4,4,14,45
3865,Delta,JFK,MIA,1,34,42,1,1,78
3866,American,ORD,PHX,21,18,14,14,0,46
3867,JetBlue,JFK,BOS,22,16,13,11,20,60
3868,Southwest,ATL,SEA,4,17,42,13,24,96
3869,United,DFW,MIA,6,5,8,8,0,21
3870,United,JFK,MIA,21,52,1,6,22,81
3871,American,LAX,BOS,3,49,18,11,16,94
3872,Southwest,LAX,BOS,5,11,47,9,6,73
3873,JetBlue,DFW,SEA,19,19,34,10,3,66
3874,Delta,LAX,MIA,13,27,48,0,15,90
3875,United,JFK,BOS,5,30,10,1,5,46
3876,Delta,DFW,SEA,3,27,33,14,28,102
3877,United,JFK,DEN,14,35,32,3,22,92
3878,American,ORD,PHX,9,25,10,8,18,61
3879,Southwest,DFW,MIA,3,36,16,3,5,60
3880,Southwest,ORD,BOS,7,43,40,2,26,111
3881,American,JFK,MIA,20,13,26,1,6,46
3882,United,LAX,PHX,4,49,51,7,8,115
3883,American,LAX,MIA,21,52,31,14,29,126
3884,Southwest,DFW,MIA,23,36,49,5,27,117
3885,Southwest,LAX,SEA,15,31,26,11,2,70
3886,Delta,ORD,SEA,5,27,23,12,21,83
3887,United,DFW,PHX,13,34,14,0,1,49
3888,United,DFW,MIA,5,49,52,4,29,134
3889,Southwest,ATL,MIA,8,7,17,4,27,55
3890,United,JFK,MIA,23,32,31,13,29,105
3891,Delta,LAX,PHX,11,26,33,6,27,92
3892,American,ATL,PHX,15,59,38,12,15,124
3893,United,LAX,PHX,16,40,44,1,18,103
3894,Southwest,DFW,PHX,13,35,3,13,26,77
3895,United,JFK,SEA,17,49,15,11,0,75
3896,JetBlue,DFW,DEN,23,35,32,8,2,77
3897,Southwest,ORD,MIA,16,42,31,1,23,97
3898,American,JFK,DEN,14,38,51,6,29,124
3899,American,LAX,MIA,15,32,39,4,2,77
3900,United,LAX,SEA,18,14,7,14,9,44
3901,JetBlue,LAX,BOS,16,38,39,6,24,107
3902,JetBlue,ATL,BOS,12,8,16,6,12,42
3903,JetBlue,LAX,BOS,23,1,20,1,10,32
3904,Delta,DFW,PHX,21,41,34,8,2,85
3905,United,DFW,BOS,4,12,56,11,10,89
3906,American,ATL,PHX,2,7,5,10,9,31
3907,United,LAX,DEN,6,27,9,3,7,46
3908,Southwest,JFK,SEA,16,22,35,1,0,58
3909,United,DFW,SEA,2,20,6,6,6,38
3910,Southwest,ORD,SEA,4,58,9,10,28,105
3911,Delta,JFK,BOS,11,59,6,8,13,86
3912,Southwest,DFW,MIA,21,55,9,6,24,94
3913,Delta,JFK,MIA,1,46,45,11,18,120
3914,American,JFK,SEA,3,5,57,8,16,86
3915,Delta,LAX,DEN,18,19,20,1,14,54
3916,American,ORD,MIA,7,8,58,7,9,82
3917,American,DFW,PHX,22,24,50,5,17,96
3918,American,ATL,MIA,2,35,19,10,27,91
3919,Delta,ATL,SEA,23,45,7,3,0,55
3920,Delta,ORD,DEN,3,32,8,6,16,62
3921,American,JFK,PHX,11,42,2,8,6,58
3922,American,ORD,BOS,13,35,27,3,23,88
3923,United,DFW,DEN,10,33,51,5,7,96
3924,United,DFW,SEA,11,5,52,13,19,89
3925,JetBlue,DFW,SEA,20,47,58,7,21,133
3926,JetBlue,ATL,PHX,2,5,36,3,15,59
3927,Southwest,ORD,SEA,18,57,9,3,22,91
3928,American,ORD,SEA,3,44,16,13,16,89
3929,Delta,ORD,SEA,17,37,37,11,10,95
3930,United,JFK,DEN,11,26,49,4,23,102
3931,United,JFK,SEA,5,48,9,6,13,76
3932,Southwest,DFW,BOS,22,8,36,10,11,65
3933,American,DFW,MIA,23,44,4,1,11,60
3934,Delta,LAX,PHX,11,44,51,2,14,111
3935,United,DFW,PHX,12,34,12,4,24,74
3936,Delta,LAX,DEN,20,36,35,7,3,81
3937,Southwest,ATL,SEA,7,40,47,8,26,121
3938,JetBlue,ORD,DEN,7,15,53,9,11,88
3939,Delta,LAX,BOS,23,44,33,0,26,103
3940,Delta,LAX,PHX,17,48,1,8,25,82
3941,American,ORD,DEN,23,45,41,1,17,104
3942,JetBlue,LAX,SEA,23,34,26,3,9,72
3943,Delta,LAX,SEA,3,31,31,4,26,92
3944,Southwest,ORD,MIA,12,16,47,14,18,95
3945,Southwest,DFW,BOS,22,39,20,13,9,81
3946,American,ATL,PHX,10,26,58,13,24,121
3947,Southwest,LAX,PHX,1,41,35,6,18,100
3948,Delta,ATL,PHX,13,37,5,7,22,71
3949,Southwest,ATL,MIA,22,7,43,3,27,80
3950,JetBlue,LAX,MIA,21,27,7,11,5,50
3951,United,LAX,MIA,20,35,54,14,28,131
3952,JetBlue,LAX,BOS,11,19,52,4,20,95
3953,Delta,JFK,PHX,22,2,21,13,8,44
3954,American,DFW,DEN,8,0,32,12,26,70
3955,Delta,DFW,MIA,7,19,41,1,26,87
3956,Delta,ATL,DEN,21,2,12,12,10,36
3957,United,LAX,SEA,9,22,8,4,21,55
3958,American,LAX,SEA,21,48,23,0,4,75
3959,Southwest,ATL,DEN,5,51,53,5,12,121
3960,JetBlue,JFK,MIA,7,41,48,3,25,117
3961,American,ORD,SEA,17,38,12,3,8,61
3962,Southwest,DFW,BOS,23,45,44,3,12,104
3963,United,DFW,SEA,14,22,19,9,16,66
3964,Southwest,ATL,PHX,11,36,36,14,7,93
3965,United,DFW,BOS,15,58,9,0,9,76
3966,Southwest,JFK,BOS,11,2,31,7,5,45
3967,JetBlue,ORD,DEN,21,27,54,10,12,103
3968,American,DFW,DEN,13,6,18,7,8,39
3969,Delta,DFW,DEN,6,34,55,10,12,111
3970,JetBlue,DFW,DEN,22,57,14,0,17,88
3971,United,JFK,DEN,16,44,34,6,2,86
3972,United,LAX,SEA,7,51,43,8,26,128
3973,Delta,JFK,SEA,14,40,10,8,12,70
3974,United,ATL,DEN,13,48,50,13,11,122
3975,JetBlue,ATL,DEN,16,13,39,2,20,74
3976,American,JFK,BOS,3,39,48,13,1,101
3977,JetBlue,DFW,DEN,21,34,38,2,12,86
3978,JetBlue,ORD,MIA,0,1,55,6,10,72
3979,Southwest,JFK,BOS,15,36,37,7,11,91
3980,United,DFW,PHX,13,31,1,12,18,62
3981,Delta,ATL,BOS,23,19,20,8,15,62
3982,American,JFK,MIA,19,59,21,11,24,115
3983,JetBlue,JFK,SEA,16,6,4,5,2,17
3984,Delta,ATL,MIA,13,54,9,7,25,95
3985,Southwest,JFK,MIA,22,34,26,9,3,72
3986,United,LAX,DEN,0,28,30,1,13,72
3987,JetBlue,ATL,MIA,15,58,39,2,10,109
3988,Southwest,JFK,MIA,8,48,55,11,20,134
3989,American,ORD,DEN,9,7,48,14,15,84
3990,JetBlue,ORD,SEA,3,14,40,14,25,93
3991,JetBlue,ORD,BOS,1,43,56,2,1,102
3992,Southwest,LAX,PHX,10,48,50,1,4,103
3993,Delta,ORD,SEA,10,27,53,5,18,103
3994,JetBlue,LAX,SEA,13,21,55,8,11,95
3995,Southwest,LAX,MIA,8,40,1,12,18,71
3996,United,ORD,PHX,11,33,38,9,7,87
3997,American,ORD,PHX,8,56,30,6,23,115
3998,American,ORD,MIA,18,5,18,5,16,44
3999,American,ORD,MIA,2,46,25,8,25,104
4000,JetBlue,DFW,DEN,22,23,53,12,21,109
4001,United,LAX,SEA,3,34,54,5,20,113
4002,JetBlue,DFW,PHX,14,57,16,5,3,81
4003,JetBlue,JFK,MIA,19,52,46,10,15,123
4004,American,LAX,MIA,11,5,24,14,29,72
4005,Delta,ORD,PHX,3,21,32,7,11,71
4006,Delta,LAX,SEA,3,18,2,2,13,35
4007,American,ATL,DEN,22,22,56,5,9,92
4008,United,DFW,MIA,6,56,51,10,29,146
4009,United,DFW,BOS,12,55,48,4,9,116
4010,United,ORD,SEA,1,11,26,4,13,54
4011,United,DFW,SEA,12,40,18,2,0,60
4012,Delta,ATL,DEN,19,39,59,12,22,132
4013,American,ATL,SEA,11,6,43,6,14,69
4014,United,LAX,PHX,16,28,19,10,7,64
4015,United,ORD,SEA,6,37,32,5,14,88
4016,JetBlue,ORD,DEN,7,55,57,6,7,125
4017,United,DFW,DEN,2,17,24,9,13,63
4018,Southwest,ATL,MIA,23,39,5,14,29,87
4019,United,ATL,PHX,11,24,56,0,13,93
4020,United,LAX,DEN,21,25,44,14,1,84
4021,Southwest,ORD,SEA,5,56,0,9,7,72
4022,Delta,DFW,SEA,16,14,46,3,12,75
4023,United,LAX,PHX,20,23,43,3,7,76
4024,JetBlue,JFK,PHX,12,42,11,1,16,70
4025,Southwest,DFW,SEA,4,41,41,6,1,89
4026,American,ORD,DEN,8,56,41,3,6,106
4027,United,ATL,DEN,11,31,22,1,20,74
4028,JetBlue,DFW,MIA,12,29,54,9,14,106
4029,Delta,DFW,SEA,20,14,37,7,5,63
4030,United,LAX,BOS,11,13,35,9,25,82
4031,Delta,JFK,MIA,21,46,34,14,7,101
4032,Southwest,ATL,DEN,21,57,13,6,7,83
4033,JetBlue,DFW,BOS,22,23,43,12,16,94
4034,Southwest,DFW,SEA,9,35,47,11,15,108
4035,United,JFK,SEA,14,9,48,7,19,83
4036,United,DFW,MIA,7,38,36,10,2,86
4037,JetBlue,DFW,MIA,14,6,9,2,15,32
4038,JetBlue,JFK,SEA,4,37,50,4,23,114
4039,American,DFW,SEA,23,33,46,0,17,96
4040,American,DFW,DEN,10,57,26,2,8,93
4041,American,ORD,PHX,14,53,46,4,18,121
4042,Southwest,ATL,DEN,12,38,48,1,22,109
4043,Southwest,ORD,SEA,14,24,56,0,17,97
4044,JetBlue,ORD,PHX,13,12,1,8,22,43
4045,JetBlue,DFW,MIA,20,7,38,0,22,67
4046,Delta,ATL,BOS,18,13,54,12,9,88
4047,Delta,ATL,DEN,21,22,12,13,4,51
4048,Southwest,ATL,DEN,8,2,58,3,11,74
4049,American,ATL,DEN,20,27,22,1,29,79
4050,Southwest,JFK,PHX,2,2,29,13,11,55
4051,American,DFW,MIA,14,1,5,6,19,31
4052,American,ATL,DEN,12,32,47,6,11,96
4053,United,JFK,PHX,15,1,2,5,4,12
4054,Southwest,ATL,DEN,21,56,34,9,23,122
4055,United,DFW,MIA,11,29,28,3,11,71
4056,Delta,ORD,DEN,7,38,22,12,17,89
4057,Southwest,DFW,MIA,5,49,14,4,12,79
4058,United,LAX,SEA,21,44,10,12,19,85
4059,Southwest,LAX,SEA,22,34,41,2,26,103
4060,JetBlue,JFK,DEN,1,44,27,14,4,89
4061,Delta,JFK,PHX,6,9,29,9,13,60
4062,American,LAX,BOS,10,26,59,3,27,115
4063,JetBlue,JFK,PHX,7,48,24,3,20,95
4064,American,ATL,BOS,16,35,4,4,21,64
4065,United,DFW,SEA,22,22,18,8,20,68
4066,JetBlue,ORD,DEN,19,48,40,13,21,122
4067,Delta,ATL,MIA,5,10,50,1,28,89
4068,American,JFK,PHX,14,58,39,3,20,120
4069,Delta,DFW,SEA,6,57,50,9,18,134
4070,American,LAX,DEN,14,12,27,4,16,59
4071,Delta,ORD,SEA,9,45,43,13,22,123
4072,JetBlue,DFW,SEA,16,43,32,2,28,105
4073,Delta,DFW,BOS,12,1,29,2,5,37
4074,American,ATL,PHX,8,7,56,12,20,95
4075,Southwest,DFW,SEA,0,20,39,13,10,82
4076,JetBlue,JFK,MIA,4,14,2,5,4,25
4077,Delta,ORD,MIA,21,4,45,6,6,61
4078,JetBlue,ORD,PHX,18,4,26,4,26,60
4079,American,ORD,SEA,3,11,19,4,8,42
4080,JetBlue,DFW,BOS,4,33,3,1,21,58
4081,American,DFW,PHX,10,46,20,2,3,71
4082,Southwest,DFW,MIA,11,59,12,6,5,82
4083,Delta,ORD,DEN,13,27,21,7,21,76
4084,United,LAX,SEA,4,21,24,12,17,74
4085,JetBlue,ORD,DEN,18,1,21,14,27,63
4086,United,LAX,SEA,20,8,9,1,27,45
4087,Southwest,JFK,BOS,15,54,20,10,3,87
4088,JetBlue,LAX,PHX,8,28,0,14,23,65
4089,United,ATL,SEA,20,45,53,10,19,127
4090,JetBlue,ORD,SEA,14,41,29,7,27,104
4091,JetBlue,DFW,BOS,21,12,35,2,6,55
4092,Southwest,ORD,MIA,12,36,28,8,18,90
4093,Southwest,JFK,BOS,16,26,9,12,10,57
4094,Southwest,LAX,PHX,8,19,32,12,4,67
4095,Delta,ATL,MIA,13,17,53,4,25,99
4096,JetBlue,ORD,DEN,1,12,49,3,24,88
4097,JetBlue,JFK,BOS,22,30,8,7,11,56
4098,Southwest,DFW,BOS,12,0,3,13,4,20
4099,Delta,JFK,DEN,2,6,28,1,24,59
4100,Delta,JFK,DEN,21,20,50,13,22,105
4101,United,ORD,MIA,21,9,56,6,2,73
4102,American,LAX,DEN,22,12,44,6,9,71
4103,American,ATL,BOS,7,2,44,2,1,49
4104,American,DFW,SEA,6,12,25,5,13,55
4105,American,LAX,DEN,18,15,32,1,16,64
4106,United,JFK,PHX,4,57,6,12,10,85
4107,Delta,ATL,DEN,15,6,40,1,21,68
4108,Delta,LAX,DEN,22,25,19,0,8,52
4109,Delta,DFW,BOS,19,5,56,7,1,69
4110,United,LAX,BOS,6,30,10,3,15,58
4111,Delta,LAX,MIA,23,50,32,11,14,107
4112,Southwest,ATL,BOS,20,56,53,10,13,132
4113,JetBlue,LAX,BOS,3,31,36,3,10,80
4114,American,LAX,SEA,22,29,11,7,2,49
4115,United,LAX,SEA,11,23,27,4,22,76
4116,Southwest,LAX,PHX,3,33,44,3,9,89
4117,Delta,LAX,DEN,13,33,7,6,29,75
4118,American,ORD,SEA,18,47,15,13,29,104
4119,Southwest,JFK,MIA,10,32,16,8,19,75
4120,American,LAX,SEA,17,11,0,0,29,40
4121,United,LAX,MIA,19,13,47,2,27,89
4122,JetBlue,ORD,MIA,16,15,43,9,15,82
4123,Delta,JFK,BOS,6,51,24,2,25,102
4124,JetBlue,ATL,PHX,8,30,30,11,16,87
4125,Delta,ATL,PHX,21,1,36,1,16,54
4126,Delta,DFW,MIA,19,9,13,13,5,40
4127,Southwest,LAX,DEN,4,59,39,4,16,118
4128,JetBlue,ATL,SEA,16,6,39,6,3,54
4129,JetBlue,JFK,MIA,17,30,57,2,1,90
4130,American,DFW,PHX,23,36,42,0,28,106
4131,Delta,LAX,BOS,15,37,59,9,5,110
4132,United,ORD,DEN,2,38,22,4,14,78
4133,Delta,ATL,DEN,22,29,31,3,25,88
4134,American,LAX,SEA,6,7,34,7,5,53
4135,United,ORD,PHX,7,6,29,14,12,61
4136,Delta,JFK,PHX,19,49,35,8,17,109
4137,American,ATL,SEA,9,47,14,10,3,74
4138,Southwest,ATL,SEA,22,6,22,8,15,51
4139,United,LAX,DEN,16,5,2,13,20,40
4140,JetBlue,DFW,BOS,11,34,13,14,28,89
4141,JetBlue,JFK,MIA,17,10,2,13,6,31
4142,United,ATL,BOS,7,57,43,0,11,111
4143,JetBlue,JFK,PHX,8,38,27,2,21,88
4144,American,ATL,BOS,21,11,20,1,2,34
4145,American,ORD,BOS,9,22,54,12,16,104
4146,Southwest,LAX,DEN,8,38,31,10,7,86
4147,Delta,ATL,SEA,14,30,0,9,17,56
4148,Delta,JFK,SEA,23,1,59,9,28,97
4149,American,DFW,DEN,23,19,5,12,7,43
4150,Delta,DFW,PHX,8,13,11,14,4,42
4151,United,JFK,DEN,7,54,14,6,19,93
4152,Southwest,DFW,DEN,19,9,48,12,4,73
4153,JetBlue,DFW,PHX,14,20,21,13,0,54
4154,American,JFK,PHX,10,56,52,6,29,143
4155,Delta,LAX,DEN,11,51,20,10,0,81
4156,Southwest,ATL,MIA,22,3,28,12,2,45
4157,Southwest,ATL,PHX,6,24,30,9,20,83
4158,American,ATL,SEA,22,29,27,13,25,94
4159,Southwest,ORD,DEN,5,41,27,13,28,109
4160,Southwest,DFW,BOS,22,12,42,6,14,74
4161,Southwest,DFW,SEA,11,3,50,12,14,79
4162,JetBlue,LAX,MIA,20,3,36,10,10,59
4163,Southwest,ORD,SEA,20,15,18,4,28,65
4164,Delta,ORD,BOS,7,38,42,1,2,83
4165,Delta,ORD,PHX,4,40,36,8,12,96
4166,United,DFW,MIA,9,10,11,10,20,51
4167,United,DFW,BOS,18,0,10,13,21,44
4168,United,JFK,BOS,3,17,2,9,2,30
4169,Southwest,LAX,PHX,18,31,23,0,21,75
4170,Delta,ORD,PHX,11,21,36,14,19,90
4171,Southwest,LAX,PHX,20,2,34,8,17,61
4172,American,JFK,MIA,20,37,1,5,20,63
4173,Southwest,ORD,BOS,20,43,13,1,20,77
4174,Delta,JFK,MIA,18,23,36,4,2,65
4175,Southwest,ORD,PHX,23,59,43,11,1,114
4176,American,JFK,MIA,20,11,34,12,14,71
4177,Southwest,ORD,SEA,12,2,59,7,16,84
4178,Southwest,ATL,DEN,7,26,40,11,10,87
4179,JetBlue,JFK,DEN,15,29,52,11,29,121
4180,JetBlue,ATL,MIA,10,21,52,0,22,95
4181,Delta,LAX,DEN,21,43,17,10,14,84
4182,Southwest,ATL,DEN,2,7,12,5,20,44
4183,JetBlue,JFK,PHX,18,23,45,14,18,100
4184,Southwest,ORD,SEA,14,28,23,12,16,79
4185,American,LAX,MIA,0,2,39,7,15,63
4186,Southwest,ATL,BOS,17,15,15,14,23,67
4187,American,ORD,BOS,22,33,49,4,11,97
4188,Southwest,LAX,SEA,22,30,35,4,13,82
4189,Southwest,ORD,BOS,15,23,7,9,24,63
4190,JetBlue,JFK,PHX,7,33,57,8,20,118
4191,American,ATL,PHX,1,27,58,10,12,107
4192,JetBlue,JFK,MIA,20,38,32,0,28,98
4193,American,JFK,BOS,16,7,5,0,28,40
4194,JetBlue,LAX,SEA,10,49,18,11,12,90
4195,Delta,LAX,BOS,15,29,55,6,8,98
4196,American,LAX,SEA,0,15,18,3,26,62
4197,JetBlue,JFK,SEA,0,8,10,1,25,44
4198,United,LAX,PHX,8,41,17,0,24,82
4199,American,LAX,MIA,22,55,46,7,18,126
4200,United,DFW,SEA,12,20,10,10,15,55
4201,Southwest,JFK,PHX,18,53,14,2,6,75
4202,Southwest,JFK,DEN,20,55,11,8,3,77
4203,Delta,ATL,MIA,17,59,6,8,7,80
4204,American,ORD,DEN,23,58,10,5,18,91
4205,American,DFW,SEA,5,8,54,9,13,84
4206,Southwest,DFW,BOS,16,17,20,0,21,58
4207,United,DFW,MIA,4,21,24,13,13,71
4208,United,ATL,PHX,11,3,9,0,17,29
4209,JetBlue,ATL,DEN,8,27,19,11,25,82
4210,Delta,JFK,BOS,19,56,57,3,17,133
4211,United,DFW,PHX,22,13,38,1,26,78
4212,United,ATL,SEA,11,36,59,10,13,118
4213,Southwest,LAX,DEN,13,48,11,2,26,87
4214,JetBlue,LAX,MIA,13,44,49,4,15,112
4215,American,ORD,DEN,8,3,57,2,28,90
4216,United,LAX,BOS,2,20,14,14,4,52
4217,Southwest,ATL,MIA,1,5,1,12,10,28
4218,American,JFK,DEN,2,27,45,2,11,85
4219,Delta,ATL,DEN,20,43,33,2,8,86
4220,United,JFK,PHX,21,51,3,0,18,72
4221,Delta,JFK,PHX,18,26,37,8,29,100
4222,United,LAX,BOS,17,24,5,5,12,46
4223,Delta,LAX,SEA,6,0,41,11,23,75
4224,Southwest,ATL,MIA,21,14,8,0,29,51
4225,American,JFK,SEA,19,39,30,7,13,89
4226,Delta,LAX,PHX,18,11,36,6,16,69
4227,American,ORD,MIA,22,52,55,9,10,126
4228,United,JFK,DEN,10,6,1,12,20,39
4229,JetBlue,ORD,PHX,9,5,41,5,19,70
4230,American,LAX,BOS,1,40,8,13,10,71
4231,Delta,LAX,MIA,13,34,12,9,10,65
4232,Southwest,ATL,PHX,12,32,41,8,13,94
4233,Delta,ORD,PHX,20,34,17,2,15,68
4234,JetBlue,JFK,PHX,20,3,43,12,16,74
4235,Southwest,JFK,PHX,18,49,54,4,15,122
4236,JetBlue,JFK,MIA,16,34,23,12,5,74
4237,Southwest,ATL,PHX,18,20,5,4,19,48
4238,Southwest,LAX,BOS,20,24,52,9,11,96
4239,Southwest,ORD,SEA,12,48,15,5,4,72
4240,JetBlue,JFK,BOS,23,20,0,0,21,41
4241,Southwest,LAX,DEN,0,7,37,13,16,73
4242,United,DFW,DEN,4,20,11,5,17,53
4243,United,ORD,SEA,21,19,50,10,20,99
4244,United,JFK,PHX,17,55,48,10,11,124
4245,Southwest,ORD,DEN,16,53,27,4,16,100
4246,Delta,JFK,BOS,16,42,41,10,10,103
4247,Delta,LAX,SEA,19,34,52,4,3,93
4248,American,ATL,BOS,19,1,16,13,10,40
4249,American,ATL,SEA,23,56,54,4,0,114
4250,United,JFK,PHX,8,28,57,5,26,116
4251,Southwest,JFK,MIA,13,36,16,13,25,90
4252,JetBlue,ORD,PHX,8,23,57,3,10,93
4253,United,ORD,DEN,10,29,51,11,3,94
4254,American,DFW,DEN,22,46,23,13,9,91
4255,Delta,JFK,PHX,4,34,4,11,11,60
4256,JetBlue,JFK,DEN,10,51,44,6,10,111
4257,United,ATL,BOS,11,35,24,2,9,70
4258,Southwest,ORD,BOS,4,57,36,11,11,115
4259,JetBlue,LAX,SEA,3,31,47,3,16,97
4260,JetBlue,ORD,MIA,5,50,45,14,18,127
4261,Southwest,ORD,MIA,18,33,49,1,12,95
4262,JetBlue,ATL,PHX,22,36,22,10,4,72
4263,Southwest,DFW,BOS,10,39,16,5,14,74
4264,United,JFK,SEA,9,20,42,1,25,88
4265,Southwest,ORD,BOS,6,9,38,5,29,81
4266,American,JFK,MIA,12,3,47,11,6,67
4267,JetBlue,LAX,MIA,7,24,7,0,24,55
4268,United,JFK,SEA,9,31,55,8,18,112
4269,American,DFW,SEA,9,16,26,6,5,53
4270,JetBlue,JFK,SEA,0,8,5,0,1,14
4271,JetBlue,DFW,SEA,3,23,57,0,9,89
4272,United,LAX,PHX,14,10,35,8,23,76
4273,Southwest,ATL,BOS,15,52,20,6,18,96
4274,American,LAX,DEN,8,38,25,4,5,72
4275,JetBlue,JFK,BOS,0,5,52,13,3,73
4276,United,ATL,MIA,4,11,44,14,14,83
4277,United,ATL,DEN,12,56,3,5,25,89
4278,United,DFW,BOS,4,37,4,11,22,74
4279,Southwest,ATL,PHX,13,9,38,6,7,60
4280,American,DFW,MIA,7,2,4,14,4,24
4281,JetBlue,ATL,MIA,9,3,23,4,24,54
4282,JetBlue,LAX,BOS,0,25,28,13,21,87
4283,JetBlue,LAX,BOS,20,9,0,9,22,40
4284,Southwest,LAX,SEA,5,36,49,4,16,105
4285,American,ATL,BOS,9,52,43,8,6,109
4286,JetBlue,JFK,BOS,17,30,2,6,18,56
4287,Southwest,JFK,MIA,5,38,37,11,0,86
4288,Southwest,ATL,BOS,8,32,4,2,13,51
4289,United,ATL,SEA,2,33,12,7,16,68
4290,United,LAX,BOS,14,56,15,0,20,91
4291,United,LAX,BOS,21,22,43,5,0,70
4292,American,ORD,BOS,3,8,24,0,19,51
4293,American,JFK,DEN,8,11,58,10,12,91
4294,Delta,JFK,MIA,13,45,48,10,12,115
4295,Southwest,ORD,DEN,18,3,8,2,12,25
4296,Delta,DFW,SEA,14,34,58,8,7,107
4297,JetBlue,LAX,DEN,2,1,49,9,22,81
4298,American,JFK,PHX,19,10,17,1,13,41
4299,JetBlue,LAX,MIA,18,16,56,14,7,93
4300,Southwest,ORD,SEA,23,20,18,4,20,62
4301,Southwest,LAX,MIA,7,39,40,14,21,114
4302,Southwest,ATL,MIA,5,53,25,0,2,80
4303,United,ATL,SEA,6,31,41,8,15,95
4304,Southwest,DFW,PHX,4,50,7,3,2,62
4305,Delta,ORD,BOS,9,30,13,1,14,58
4306,Southwest,ORD,MIA,13,55,10,6,11,82
4307,Delta,ORD,DEN,16,8,40,2,28,78
4308,JetBlue,ORD,MIA,21,34,21,7,0,62
4309,Delta,ATL,PHX,23,8,11,4,7,30
4310,Delta,JFK,PHX,12,47,37,9,0,93
4311,American,ATL,BOS,2,30,16,14,6,66
4312,American,ORD,DEN,9,51,59,14,22,146
4313,Delta,DFW,SEA,16,38,31,9,10,88
4314,American,JFK,BOS,16,1,17,2,15,35
4315,American,DFW,SEA,15,19,23,0,16,58
4316,Delta,ORD,MIA,8,23,14,1,6,44
4317,United,ORD,PHX,21,11,23,1,2,37
4318,American,DFW,MIA,10,47,28,2,2,79
4319,United,ATL,BOS,2,23,46,5,6,80
4320,American,ATL,DEN,2,16,25,12,28,81
4321,United,LAX,SEA,18,43,29,6,26,104
4322,United,ORD,MIA,5,35,0,10,23,68
4323,Southwest,ORD,PHX,14,13,39,6,7,65
4324,Southwest,LAX,SEA,22,24,55,8,23,110
4325,American,ORD,PHX,14,0,46,2,11,59
4326,United,ORD,PHX,22,8,17,12,26,63
4327,Southwest,JFK,BOS,8,35,41,1,16,93
4328,United,DFW,PHX,23,47,32,8,6,93
4329,Southwest,ATL,BOS,17,11,38,7,23,79
4330,United,ORD,DEN,0,57,14,11,28,110
4331,United,ORD,BOS,5,32,26,7,29,94
4332,Delta,LAX,DEN,17,26,5,3,12,46
4333,JetBlue,LAX,MIA,2,14,5,11,22,52
4334,American,JFK,BOS,2,46,41,5,6,98
4335,JetBlue,ATL,BOS,18,11,23,14,13,61
4336,American,LAX,DEN,9,7,50,0,16,73
4337,Southwest,JFK,PHX,15,38,27,1,12,78
4338,United,JFK,BOS,12,35,52,5,22,114
4339,Southwest,LAX,MIA,7,39,33,12,24,108
4340,JetBlue,DFW,MIA,1,17,3,12,26,58
4341,United,JFK,PHX,2,23,19,0,0,42
4342,Southwest,ATL,BOS,14,12,3,2,17,34
4343,American,DFW,MIA,19,42,6,1,1,50
4344,United,ATL,MIA,11,2,14,7,8,31
4345,United,DFW,MIA,16,3,52,10,17,82
4346,United,DFW,MIA,14,7,4,1,7,19
4347,American,ORD,MIA,8,49,41,10,25,125
4348,United,ATL,PHX,13,15,13,1,22,51
4349,JetBlue,JFK,PHX,17,57,46,8,20,131
4350,Southwest,ATL,MIA,17,6,40,5,12,63
4351,Southwest,DFW,BOS,1,35,17,10,17,79
4352,JetBlue,ORD,PHX,17,28,47,13,27,115
4353,American,LAX,DEN,18,48,19,9,7,83
4354,Delta,ORD,DEN,0,54,48,0,5,107
4355,JetBlue,ORD,PHX,5,35,17,11,3,66
4356,Delta,ATL,DEN,21,0,37,8,25,70
4357,Southwest,ORD,MIA,10,47,43,11,21,122
4358,United,ATL,PHX,8,3,13,8,1,25
4359,JetBlue,JFK,MIA,15,21,50,11,28,110
4360,Delta,ORD,SEA,20,51,36,10,15,112
4361,American,JFK,MIA,0,54,10,3,7,74
4362,Southwest,DFW,MIA,16,24,5,5,14,48
4363,Southwest,JFK,BOS,12,1,52,5,21,79
4364,Southwest,JFK,PHX,14,36,29,8,13,86
4365,United,LAX,SEA,0,10,34,14,4,62
4366,American,ATL,PHX,2,10,43,9,20,82
4367,JetBlue,DFW,DEN,21,55,56,7,4,122
4368,Southwest,ORD,BOS,5,11,49,3,2,65
4369,Southwest,JFK,MIA,1,33,8,10,11,62
4370,United,ORD,PHX,18,45,25,6,8,84
4371,JetBlue,LAX,PHX,7,55,54,9,6,124
4372,United,DFW,BOS,13,4,10,12,14,40
4373,American,LAX,DEN,18,28,39,8,7,82
4374,Southwest,LAX,MIA,15,20,28,7,29,84
4375,Southwest,ORD,SEA,2,50,48,13,17,128
4376,Delta,ATL,SEA,6,16,22,6,3,47
4377,United,ORD,MIA,6,47,45,12,12,116
4378,Delta,LAX,SEA,19,27,11,6,15,59
4379,United,JFK,MIA,2,35,53,8,19,115
4380,Southwest,DFW,MIA,7,29,33,2,7,71
4381,United,ATL,PHX,0,55,10,10,29,104
4382,JetBlue,LAX,BOS,18,58,4,13,2,77
4383,American,DFW,DEN,0,55,26,11,22,114
4384,United,ATL,MIA,0,56,6,10,10,82
4385,Southwest,LAX,MIA,1,42,31,9,2,84
4386,American,DFW,PHX,16,19,7,3,13,42
4387,American,DFW,PHX,0,41,6,4,18,69
4388,JetBlue,ATL,DEN,0,27,38,4,23,92
4389,American,LAX,PHX,8,28,14,2,15,59
4390,Delta,DFW,PHX,16,22,1,14,4,41
4391,Southwest,ATL,BOS,8,3,37,5,14,59
4392,United,ORD,DEN,3,5,16,14,2,37
4393,Delta,JFK,PHX,18,7,19,3,16,45
4394,JetBlue,JFK,BOS,17,53,18,7,22,100
4395,JetBlue,ATL,SEA,10,35,43,9,12,99
4396,JetBlue,DFW,PHX,1,12,18,6,15,51
4397,Delta,LAX,MIA,9,28,0,10,23,61
4398,United,ATL,SEA,16,37,6,1,17,61
4399,JetBlue,JFK,DEN,13,7,11,12,1,31
4400,United,LAX,MIA,14,13,57,11,11,92
4401,JetBlue,ATL,PHX,23,22,3,0,27,52
4402,Southwest,LAX,SEA,6,27,41,1,18,87
4403,American,ORD,MIA,7,55,47,9,23,134
4404,American,DFW,SEA,20,5,35,10,16,66
4405,Delta,ATL,MIA,7,22,7,7,1,37
4406,United,DFW,DEN,1,13,15,1,27,56
4407,American,JFK,SEA,5,49,18,1,19,87
4408,American,JFK,SEA,5,52,2,3,5,62
4409,JetBlue,DFW,MIA,20,25,43,0,9,77
4410,American,DFW,MIA,18,5,30,14,8,57
4411,United,JFK,SEA,23,6,25,11,16,58
4412,Delta,JFK,PHX,12,29,37,14,20,100
4413,Southwest,JFK,DEN,23,9,10,10,20,49
4414,American,DFW,PHX,7,31,25,5,13,74
4415,United,ORD,BOS,18,5,25,7,24,61
4416,United,ATL,DEN,20,9,56,8,12,85
4417,Delta,LAX,BOS,11,16,14,13,20,63
4418,American,LAX,BOS,8,17,43,12,13,85
4419,United,DFW,BOS,5,31,17,2,19,69
4420,JetBlue,DFW,BOS,17,47,6,13,1,67
4421,American,ATL,PHX,20,20,21,13,15,69
4422,Delta,DFW,BOS,17,6,11,6,16,39
4423,American,JFK,MIA,9,28,17,8,2,55
4424,Delta,ATL,MIA,11,50,31,3,15,99
4425,American,DFW,PHX,9,37,7,2,22,68
4426,United,DFW,DEN,20,5,1,11,15,32
4427,United,ATL,MIA,17,39,14,11,14,78
4428,Southwest,LAX,SEA,15,9,22,9,21,61
4429,American,ORD,DEN,1,48,6,3,0,57
4430,Southwest,LAX,MIA,3,55,52,12,24,143
4431,American,JFK,MIA,22,34,7,3,11,55
4432,Southwest,ATL,SEA,2,3,26,11,14,54
4433,American,ATL,DEN,16,25,36,2,2,65
4434,Southwest,ORD,SEA,12,58,36,13,6,113
4435,United,ORD,PHX,4,58,58,7,23,146
4436,Southwest,DFW,MIA,6,2,7,9,17,35
4437,American,DFW,DEN,1,54,31,6,20,111
4438,United,LAX,MIA,4,38,0,6,18,62
4439,Southwest,JFK,MIA,9,51,28,14,28,121
4440,JetBlue,DFW,DEN,4,57,51,5,4,117
4441,United,ORD,BOS,11,37,11,8,19,75
4442,JetBlue,ATL,PHX,19,50,51,11,13,125
4443,Southwest,JFK,MIA,13,52,21,4,26,103
4444,Delta,DFW,MIA,11,0,29,12,8,49
4445,United,JFK,PHX,15,20,30,13,27,90
4446,United,ATL,PHX,18,30,28,14,26,98
4447,JetBlue,JFK,DEN,3,55,24,3,9,91
4448,United,DFW,SEA,20,33,15,14,3,65
4449,Southwest,ORD,MIA,23,52,10,11,19,92
4450,Southwest,JFK,PHX,2,10,34,10,21,75
4451,Southwest,LAX,PHX,10,2,11,9,11,33
4452,JetBlue,ATL,MIA,10,53,57,4,8,122
4453,United,ATL,DEN,1,39,42,1,1,83
4454,JetBlue,DFW,MIA,19,14,41,14,4,73
4455,Delta,LAX,BOS,13,41,22,6,25,94
4456,Delta,JFK,DEN,8,58,1,2,2,63
4457,Delta,JFK,SEA,15,4,56,4,11,75
4458,Southwest,JFK,DEN,20,49,7,14,8,78
4459,Delta,LAX,DEN,18,55,59,1,7,122
4460,Southwest,LAX,SEA,9,40,42,3,21,106
4461,United,JFK,DEN,23,41,24,7,24,96
4462,Southwest,DFW,BOS,19,55,52,9,0,116
4463,United,ORD,MIA,2,10,56,3,5,74
4464,American,ATL,SEA,18,49,39,2,15,105
4465,Delta,LAX,BOS,11,0,21,2,15,38
4466,Delta,JFK,MIA,23,23,17,1,7,48
4467,Southwest,JFK,DEN,13,25,39,6,2,72
4468,Southwest,LAX,MIA,18,6,53,14,6,79
4469,American,ORD,MIA,20,4,39,12,24,79
4470,Delta,DFW,PHX,10,1,52,12,6,71
4471,Delta,ORD,PHX,20,44,48,6,24,122
4472,Southwest,DFW,DEN,21,2,45,7,22,76
4473,American,LAX,PHX,14,29,33,4,18,84
4474,Southwest,ORD,MIA,9,34,43,10,1,88
4475,JetBlue,DFW,SEA,7,57,56,5,3,121
4476,JetBlue,DFW,PHX,13,22,12,13,20,67
4477,Southwest,ORD,BOS,12,38,26,2,10,76
4478,Delta,DFW,BOS,16,33,40,1,18,92
4479,Southwest,ORD,MIA,15,2,10,1,6,19
4480,Delta,JFK,BOS,22,48,45,8,10,111
4481,Southwest,JFK,SEA,20,49,51,5,15,120
4482,Southwest,ORD,MIA,15,40,57,8,4,109
4483,Delta,JFK,BOS,7,32,52,11,9,104
4484,Delta,ATL,SEA,23,34,44,12,24,114
4485,American,ATL,MIA,5,23,56,10,5,94
4486,Delta,LAX,SEA,13,14,21,9,20,64
4487,Delta,DFW,SEA,1,51,10,10,1,72
4488,United,ATL,MIA,10,16,3,10,26,55
4489,Delta,ATL,DEN,0,11,51,13,13,88
4490,American,DFW,MIA,23,35,34,4,25,98
4491,Delta,ORD,DEN,12,10,23,6,1,40
4492,American,ATL,BOS,5,49,42,2,16,109
4493,JetBlue,ORD,MIA,14,42,16,3,21,82
4494,United,JFK,SEA,18,42,50,13,29,134
4495,United,ATL,MIA,13,47,18,1,10,76
4496,Delta,JFK,SEA,5,51,40,5,9,105
4497,Delta,ORD,BOS,6,28,28,9,19,84
4498,Southwest,ORD,BOS,16,16,9,14,0,39
4499,JetBlue,LAX,PHX,10,9,26,6,19,60
4500,American,ATL,DEN,5,56,2,9,24,91
4501,Delta,LAX,PHX,4,10,25,1,14,50
4502,Southwest,LAX,DEN,23,46,14,9,13,82
4503,Southwest,JFK,PHX,12,7,36,0,24,67
4504,Delta,ATL,PHX,1,16,35,3,27,81
4505,Southwest,ORD,BOS,4,6,37,6,2,51
4506,United,LAX,BOS,0,3,26,11,25,65
4507,United,JFK,MIA,8,24,5,4,2,35
4508,Delta,ATL,BOS,20,22,42,1,14,79
4509,American,JFK,PHX,3,12,48,13,7,80
4510,JetBlue,ATL,MIA,21,25,29,6,11,71
4511,American,ORD,PHX,16,30,18,9,7,64
4512,United,DFW,PHX,17,46,46,8,6,106
4513,Southwest,ORD,DEN,6,25,52,9,6,92
4514,Southwest,ATL,DEN,5,56,35,13,14,118
4515,JetBlue,LAX,MIA,11,1,2,1,24,28
4516,American,JFK,DEN,13,26,37,2,5,70
4517,Southwest,ATL,DEN,3,28,46,12,5,91
4518,Southwest,JFK,PHX,10,12,52,12,24,100
4519,American,ORD,SEA,10,25,35,1,10,71
4520,Delta,ORD,SEA,10,46,10,0,0,56
4521,American,JFK,SEA,17,56,46,2,29,133
4522,United,JFK,DEN,19,40,50,0,13,103
4523,United,LAX,PHX,18,37,35,9,13,94
4524,United,DFW,PHX,22,24,2,12,1,39
4525,Southwest,LAX,MIA,17,19,7,13,19,58
4526,Southwest,ORD,PHX,9,2,44,8,29,83
4527,Delta,ATL,DEN,22,23,20,5,29,77
4528,JetBlue,ATL,MIA,11,3,24,10,23,60
4529,Delta,ORD,SEA,18,17,47,12,0,76
4530,Southwest,ORD,SEA,2,55,25,9,1,90
4531,American,LAX,SEA,14,25,31,4,23,83
4532,Southwest,DFW,BOS,6,38,28,5,12,83
4533,Southwest,LAX,DEN,8,33,8,0,6,47
4534,Delta,ORD,SEA,20,11,7,2,11,31
4535,United,ATL,DEN,11,59,17,1,16,93
4536,Southwest,DFW,SEA,11,14,16,12,20,62
4537,Southwest,LAX,MIA,19,27,42,11,19,99
4538,Southwest,DFW,MIA,16,25,17,10,0,52
4539,United,ORD,DEN,2,48,31,12,23,114
4540,Southwest,DFW,DEN,10,0,32,9,4,45
4541,American,LAX,MIA,3,50,38,7,10,105
4542,JetBlue,DFW,SEA,2,29,2,4,6,41
4543,JetBlue,ATL,DEN,23,42,44,3,0,89
4544,United,JFK,SEA,12,33,50,7,2,92
4545,United,DFW,DEN,15,52,27,8,14,101
4546,United,LAX,PHX,3,29,30,2,11,72
4547,United,ATL,SEA,13,48,7,13,14,82
4548,Southwest,LAX,DEN,1,58,55,6,10,129
4549,Delta,LAX,MIA,17,35,39,6,26,106
4550,Southwest,DFW,DEN,11,27,19,0,18,64
4551,United,ATL,PHX,11,49,7,3,13,72
4552,Southwest,ORD,MIA,4,56,3,7,3,69
4553,JetBlue,ORD,MIA,4,26,46,14,11,97
4554,Southwest,ATL,BOS,9,41,58,7,7,113
4555,Southwest,JFK,BOS,0,32,50,9,18,109
4556,American,LAX,MIA,12,19,58,7,2,86
4557,Southwest,ATL,MIA,13,40,22,1,22,85
4558,JetBlue,ORD,SEA,19,44,54,11,4,113
4559,United,ORD,MIA,6,4,39,13,22,78
4560,United,ATL,PHX,18,17,11,5,16,49
4561,United,JFK,PHX,13,1,17,6,14,38
4562,United,DFW,MIA,7,8,39,10,9,66
4563,American,ATL,DEN,8,38,43,9,15,105
4564,American,JFK,DEN,13,27,2,4,11,44
4565,United,ATL,MIA,6,46,29,12,21,108
4566,Southwest,LAX,MIA,8,33,14,14,27,88
4567,United,LAX,BOS,4,23,6,12,3,44
4568,JetBlue,ATL,PHX,8,24,6,6,9,45
4569,United,ATL,DEN,2,45,9,4,3,61
4570,Southwest,JFK,SEA,22,37,3,3,25,68
4571,Southwest,ATL,SEA,14,44,58,11,4,117
4572,JetBlue,JFK,PHX,14,16,15,4,13,48
4573,Southwest,DFW,SEA,21,35,3,3,14,55
4574,Southwest,JFK,PHX,8,54,56,5,9,124
4575,United,LAX,MIA,11,26,31,1,15,73
4576,American,ATL,BOS,16,37,30,2,22,91
4577,Delta,LAX,BOS,15,17,50,6,22,95
4578,Southwest,LAX,BOS,22,49,18,3,29,99
4579,American,JFK,SEA,19,54,14,8,16,92
4580,Southwest,ORD,SEA,0,52,48,1,2,103
4581,Southwest,JFK,MIA,22,53,26,9,29,117
4582,American,JFK,PHX,9,44,28,7,24,103
4583,Delta,DFW,DEN,7,23,19,7,6,55
4584,Southwest,JFK,BOS,1,43,20,12,20,95
4585,United,DFW,BOS,3,27,44,13,4,88
4586,JetBlue,ATL,BOS,15,26,28,7,2,63
4587,United,LAX,PHX,18,50,42,5,5,102
4588,United,DFW,PHX,23,9,26,14,26,75
4589,Delta,ATL,PHX,12,48,3,2,16,69
4590,American,LAX,SEA,15,59,21,13,8,101
4591,Southwest,JFK,DEN,22,31,54,6,26,117
4592,American,DFW,DEN,23,2,11,10,18,41
4593,Southwest,LAX,SEA,23,21,58,9,0,88
4594,American,LAX,BOS,1,43,11,11,4,69
4595,American,JFK,DEN,14,41,7,4,16,68
4596,Delta,ORD,BOS,14,47,48,2,27,124
4597,American,ORD,MIA,2,14,13,13,4,44
4598,American,LAX,BOS,18,7,51,4,25,87
4599,American,ORD,SEA,1,21,23,4,12,60
4600,JetBlue,JFK,BOS,14,48,11,12,10,81
4601,Delta,LAX,DEN,22,50,59,12,8,129
4602,United,LAX,MIA,21,54,29,0,9,92
4603,Delta,JFK,DEN,20,45,55,1,9,110
4604,JetBlue,ATL,DEN,20,27,21,9,3,60
4605,American,LAX,PHX,21,2,16,11,0,29
4606,Delta,ORD,SEA,7,43,20,5,29,97
4607,American,JFK,DEN,17,54,40,1,29,124
4608,Southwest,ATL,DEN,17,30,40,1,1,72
4609,American,JFK,BOS,3,51,50,0,18,119
4610,United,ORD,MIA,22,54,58,4,18,134
4611,American,ORD,PHX,22,27,50,6,0,83
4612,United,JFK,SEA,17,6,44,9,16,75
4613,JetBlue,ATL,SEA,0,5,33,14,14,66
4614,JetBlue,ORD,MIA,19,12,24,2,8,46
4615,Delta,DFW,PHX,19,51,8,14,6,79
4616,United,ORD,DEN,14,36,54,6,27,123
4617,American,LAX,SEA,22,3,24,10,14,51
4618,Southwest,ORD,SEA,14,8,14,12,24,58
4619,American,LAX,SEA,13,1,26,10,15,52
4620,Southwest,LAX,BOS,10,33,23,8,12,76
4621,Southwest,JFK,DEN,11,18,32,9,0,59
4622,American,ATL,PHX,11,55,33,9,14,111
4623,JetBlue,DFW,PHX,3,17,22,12,12,63
4624,American,ORD,PHX,4,53,37,6,14,110
4625,Southwest,ORD,BOS,6,6,24,11,5,46
4626,Southwest,ORD,PHX,5,32,44,6,17,99
4627,Southwest,ATL,PHX,22,53,17,8,12,90
4628,Delta,ORD,MIA,20,0,21,3,12,36
4629,Delta,ATL,DEN,15,24,0,3,16,43
4630,Delta,JFK,PHX,13,34,3,2,21,60
4631,American,DFW,SEA,0,33,36,14,19,102
4632,Delta,ORD,MIA,9,4,48,9,22,83
4633,American,DFW,DEN,23,25,22,12,15,74
4634,Southwest,ATL,MIA,13,47,19,6,8,80
4635,JetBlue,ATL,BOS,2,29,10,5,11,55
4636,American,ORD,PHX,16,38,48,5,18,109
4637,Delta,DFW,BOS,10,1,54,7,0,62
4638,JetBlue,ORD,DEN,5,55,34,3,12,104
4639,JetBlue,DFW,SEA,9,8,54,14,21,97
4640,Delta,ATL,PHX,14,0,14,10,2,26
4641,Delta,DFW,SEA,11,2,11,6,6,25
4642,Delta,DFW,PHX,19,40,29,14,6,89
4643,American,ORD,SEA,12,47,10,2,9,68
4644,United,LAX,DEN,13,24,2,9,8,43
4645,Delta,JFK,BOS,12,20,47,8,25,100
4646,Southwest,ORD,BOS,11,43,36,1,14,94
4647,Southwest,JFK,PHX,19,36,38,1,0,75
4648,Delta,JFK,SEA,5,41,28,0,3,72
4649,JetBlue,DFW,MIA,11,13,3,8,0,24
4650,United,ATL,BOS,11,12,57,9,19,97
4651,United,DFW,DEN,15,9,38,11,8,66
4652,Delta,DFW,SEA,10,40,41,1,3,85
4653,Southwest,DFW,SEA,3,0,58,1,17,76
4654,Southwest,JFK,SEA,10,17,54,3,2,76
4655,Southwest,DFW,DEN,22,46,51,2,18,117
4656,American,ATL,BOS,4,1,33,6,29,69
4657,Delta,LAX,SEA,8,49,29,12,16,106
4658,American,LAX,DEN,3,52,30,7,2,91
4659,JetBlue,DFW,PHX,23,27,49,6,9,91
4660,United,ATL,DEN,2,36,54,3,17,110
4661,Delta,ATL,MIA,5,54,26,5,7,92
4662,Southwest,JFK,DEN,10,7,45,6,9,67
4663,Delta,ATL,PHX,23,53,36,5,28,122
4664,JetBlue,JFK,BOS,7,14,25,4,11,54
4665,United,DFW,PHX,16,24,13,11,22,70
4666,United,ORD,SEA,17,44,2,0,12,58
4667,JetBlue,JFK,BOS,2,2,4,6,22,34
4668,JetBlue,DFW,MIA,13,53,33,12,1,99
4669,United,ATL,PHX,15,17,51,8,5,81
4670,American,JFK,DEN,14,29,8,8,2,47
4671,American,DFW,MIA,0,52,5,2,23,82
4672,United,ATL,DEN,20,39,31,14,17,101
4673,United,DFW,BOS,3,10,10,1,21,42
4674,United,LAX,PHX,22,7,30,9,23,69
4675,JetBlue,ATL,DEN,13,45,43,0,21,109
4676,Delta,DFW,PHX,10,30,44,13,20,107
4677,United,JFK,MIA,18,24,17,3,29,73
4678,United,DFW,BOS,21,26,20,7,28,81
4679,Southwest,ORD,SEA,0,33,38,3,21,95
4680,JetBlue,ORD,PHX,10,37,34,9,25,105
4681,Southwest,DFW,MIA,16,38,33,12,3,86
4682,JetBlue,LAX,PHX,0,37,22,7,24,90
4683,JetBlue,DFW,PHX,6,27,52,7,13,99
4684,Southwest,JFK,PHX,11,51,51,13,19,134
4685,Southwest,ATL,SEA,14,11,11,3,19,44
4686,Delta,ORD,SEA,18,52,40,13,4,109
4687,JetBlue,ORD,DEN,23,4,55,1,27,87
4688,Southwest,ORD,DEN,15,46,3,13,29,91
4689,American,ORD,MIA,12,32,16,11,3,62
4690,Delta,DFW,SEA,21,18,37,1,22,78
4691,Delta,DFW,MIA,22,23,22,7,20,72
4692,Southwest,LAX,BOS,2,26,25,3,16,70
4693,Delta,ORD,BOS,13,17,41,1,6,65
4694,American,ATL,MIA,8,5,19,7,17,48
4695,Southwest,ORD,SEA,14,27,44,13,21,105
4696,American,ORD,DEN,3,31,41,6,26,104
4697,United,LAX,PHX,16,22,57,3,24,106
4698,American,ATL,MIA,2,54,5,12,20,91
4699,Delta,ATL,MIA,13,47,28,1,19,95
4700,United,ATL,SEA,8,35,5,0,6,46
4701,Delta,ORD,DEN,1,49,52,14,22,137
4702,Delta,LAX,BOS,7,18,53,8,13,92
4703,Southwest,JFK,DEN,4,26,44,5,21,96
4704,United,JFK,MIA,18,10,31,14,5,60
4705,United,JFK,BOS,19,1,29,10,14,54
4706,Southwest,JFK,SEA,16,51,14,1,9,75
4707,Southwest,ATL,BOS,3,11,19,5,4,39
4708,Southwest,JFK,BOS,22,43,34,14,4,95
4709,Delta,ATL,DEN,4,12,46,8,1,67
4710,JetBlue,ATL,SEA,16,42,18,11,13,84
4711,American,JFK,SEA,5,56,19,9,7,91
4712,Delta,JFK,DEN,23,24,14,2,5,45
4713,Southwest,JFK,DEN,22,14,53,7,1,75
4714,American,DFW,BOS,14,4,46,2,19,71
4715,United,LAX,BOS,23,4,41,6,25,76
4716,United,JFK,MIA,13,32,30,13,21,96
4717,United,ATL,BOS,6,37,59,3,12,111
4718,Southwest,DFW,BOS,16,7,54,5,2,68
4719,American,DFW,MIA,5,40,44,3,1,88
4720,JetBlue,JFK,DEN,1,38,30,3,0,71
4721,JetBlue,JFK,SEA,12,46,33,5,21,105
4722,American,LAX,DEN,14,25,48,3,23,99
4723,Southwest,ORD,DEN,2,45,43,6,0,94
4724,Southwest,JFK,BOS,16,55,55,1,5,116
4725,American,LAX,MIA,3,10,11,3,3,27
4726,Southwest,ATL,SEA,8,10,13,12,20,55
4727,United,DFW,PHX,4,18,58,12,23,111
4728,American,LAX,SEA,8,20,54,5,29,108
4729,Southwest,ATL,BOS,18,59,48,6,8,121
4730,United,JFK,PHX,17,6,15,7,1,29
4731,Delta,DFW,DEN,22,51,24,11,2,88
4732,JetBlue,ATL,DEN,23,15,22,8,10,55
4733,Southwest,ORD,BOS,13,51,49,8,28,136
4734,Southwest,DFW,DEN,18,55,16,4,2,77
4735,Southwest,DFW,BOS,20,55,16,8,26,105
4736,Southwest,ATL,MIA,12,47,20,13,19,99
4737,Southwest,ATL,SEA,21,40,22,9,4,75
4738,United,DFW,SEA,15,9,50,0,17,76
4739,JetBlue,JFK,SEA,6,30,3,14,18,65
4740,United,LAX,DEN,12,29,57,14,26,126
4741,JetBlue,ORD,SEA,7,7,55,6,21,89
4742,Delta,ATL,BOS,18,4,48,9,26,87
4743,JetBlue,ORD,MIA,11,0,59,5,19,83
4744,Southwest,JFK,BOS,10,1,6,10,24,41
4745,United,JFK,DEN,17,24,31,13,12,80
4746,JetBlue,ORD,BOS,2,0,0,14,1,15
4747,United,ATL,SEA,20,15,8,11,6,40
4748,Southwest,JFK,DEN,5,46,0,3,4,53
4749,Delta,ATL,SEA,9,48,23,0,3,74
4750,Delta,DFW,MIA,13,43,18,2,23,86
4751,American,JFK,SEA,19,29,33,11,1,74
4752,Delta,ORD,PHX,8,20,35,2,12,69
4753,American,DFW,PHX,1,53,24,9,2,88
4754,Southwest,DFW,SEA,17,22,14,1,15,52
4755,United,ORD,DEN,23,25,55,0,19,99
4756,Southwest,JFK,DEN,5,27,54,10,15,106
4757,Southwest,DFW,BOS,1,23,1,0,23,47
4758,American,ORD,PHX,15,48,39,9,20,116
4759,American,JFK,BOS,2,44,43,6,21,114
4760,Delta,ORD,SEA,10,1,41,10,27,79
4761,United,ATL,DEN,3,2,25,10,8,45
4762,Delta,ATL,SEA,7,11,11,14,26,62
4763,JetBlue,JFK,MIA,3,20,36,2,28,86
4764,United,LAX,BOS,6,7,14,11,3,35
4765,United,LAX,SEA,12,52,52,5,20,129
4766,Delta,LAX,PHX,19,59,29,6,12,106
4767,Delta,DFW,SEA,2,49,50,5,18,122
4768,United,ORD,MIA,1,47,46,11,29,133
4769,JetBlue,LAX,PHX,16,43,39,6,8,96
4770,Southwest,ATL,DEN,19,44,57,1,20,122
4771,Delta,ATL,MIA,12,33,15,4,25,77
4772,United,ORD,DEN,4,15,27,7,18,67
4773,JetBlue,ATL,BOS,22,10,56,13,21,100
4774,JetBlue,LAX,PHX,3,43,50,14,27,134
4775,JetBlue,ORD,DEN,21,14,56,7,10,87
4776,American,JFK,MIA,3,39,6,13,8,66
4777,Southwest,JFK,BOS,12,48,5,3,1,57
4778,United,ATL,DEN,15,18,51,4,18,91
4779,American,JFK,MIA,12,46,38,1,6,91
4780,JetBlue,ORD,MIA,10,56,26,0,12,94
4781,American,LAX,DEN,3,44,57,12,17,130
4782,United,DFW,BOS,0,35,22,4,20,81
4783,Southwest,ATL,BOS,21,31,35,9,19,94
4784,American,LAX,PHX,17,53,23,2,2,80
4785,United,ORD,DEN,14,1,15,5,7,28
4786,Southwest,LAX,SEA,6,22,25,4,17,68
4787,United,JFK,SEA,3,17,9,14,19,59
4788,Southwest,ATL,BOS,16,26,10,10,28,74
4789,Southwest,ORD,MIA,6,30,3,6,4,43
4790,American,JFK,PHX,5,43,12,12,4,71
4791,Delta,ATL,SEA,22,54,23,2,27,106
4792,United,ORD,SEA,4,34,26,14,1,75
4793,Southwest,LAX,DEN,0,9,40,1,17,67
4794,United,LAX,BOS,1,43,44,6,21,114
4795,JetBlue,JFK,PHX,0,35,19,11,22,87
4796,Southwest,ATL,PHX,5,16,3,13,25,57
4797,JetBlue,JFK,SEA,17,4,42,11,18,75
4798,Delta,ORD,DEN,3,41,24,6,10,81
4799,United,JFK,BOS,0,26,49,1,13,89
4800,Delta,ATL,MIA,7,4,8,1,12,25
4801,Delta,LAX,SEA,14,1,6,10,7,24
4802,JetBlue,ATL,PHX,21,17,29,7,28,81
4803,Delta,LAX,MIA,17,45,10,8,9,72
4804,United,JFK,MIA,8,35,4,2,8,49
4805,United,ORD,BOS,4,43,20,0,28,91
4806,Southwest,ORD,PHX,17,54,13,2,5,74
4807,Southwest,ORD,DEN,8,17,56,5,27,105
4808,United,LAX,DEN,9,8,52,1,29,90
4809,United,LAX,PHX,8,46,11,7,10,74
4810,JetBlue,ORD,SEA,4,52,14,11,11,88
4811,JetBlue,JFK,PHX,20,55,7,4,27,93
4812,United,JFK,DEN,23,19,14,7,10,50
4813,United,DFW,BOS,22,33,26,5,28,92
4814,American,ATL,DEN,2,33,1,6,21,61
4815,Delta,LAX,SEA,12,9,5,6,28,48
4816,American,LAX,MIA,9,56,35,0,2,93
4817,JetBlue,LAX,BOS,8,11,45,5,10,71
4818,United,ATL,DEN,14,48,25,12,17,102
4819,United,DFW,PHX,18,1,41,13,18,73
4820,United,DFW,SEA,0,58,55,8,19,140
4821,United,JFK,PHX,5,1,56,5,19,81
4822,American,ORD,BOS,5,15,25,2,11,53
4823,Delta,ORD,SEA,10,30,23,10,0,63
4824,United,DFW,DEN,1,3,49,4,8,64
4825,American,ORD,SEA,7,49,32,10,0,91
4826,Delta,JFK,SEA,17,36,59,4,25,124
4827,American,ORD,BOS,21,30,54,10,22,116
4828,Delta,ORD,BOS,3,5,33,2,28,68
4829,Southwest,JFK,MIA,0,16,14,12,2,44
4830,Delta,JFK,DEN,13,51,53,7,26,137
4831,Southwest,LAX,PHX,8,46,3,7,9,65
4832,Southwest,ATL,BOS,4,31,43,8,17,99
4833,American,JFK,PHX,8,6,1,13,10,30
4834,American,ORD,BOS,2,57,48,13,13,131
4835,JetBlue,DFW,BOS,4,40,25,11,8,84
4836,United,ATL,SEA,0,30,34,0,14,78
4837,United,ATL,PHX,20,51,29,4,8,92
4838,Southwest,JFK,DEN,18,1,55,13,8,77
4839,JetBlue,JFK,BOS,9,15,40,14,11,80
4840,United,ATL,PHX,11,1,25,0,16,42
4841,American,DFW,MIA,12,42,37,3,11,93
4842,American,JFK,SEA,1,6,15,6,24,51
4843,United,JFK,DEN,0,49,1,6,28,84
4844,United,DFW,DEN,18,53,45,6,2,106
4845,United,ORD,MIA,5,42,24,2,23,91
4846,American,ATL,PHX,4,22,35,1,21,79
4847,United,LAX,SEA,13,29,16,12,2,59
4848,American,LAX,SEA,23,43,18,5,25,91
4849,United,LAX,PHX,21,28,23,1,16,68
4850,Southwest,DFW,SEA,18,40,21,5,10,76
4851,American,ATL,PHX,2,27,26,0,13,66
4852,United,ATL,SEA,5,29,25,12,25,91
4853,United,ATL,PHX,13,0,20,1,1,22
4854,American,LAX,MIA,20,9,47,8,28,92
4855,Delta,ORD,SEA,2,27,0,1,16,44
4856,United,DFW,DEN,18,9,54,14,24,101
4857,JetBlue,JFK,SEA,17,45,31,5,0,81
4858,United,ORD,SEA,7,47,38,8,8,101
4859,Southwest,ORD,DEN,20,40,55,2,13,110
4860,Delta,DFW,BOS,13,34,20,7,18,79
4861,Southwest,DFW,PHX,13,12,56,8,12,88
4862,American,DFW,SEA,18,48,19,10,23,100
4863,American,LAX,BOS,6,42,24,11,8,85
4864,American,ORD,BOS,21,14,20,7,21,62
4865,American,LAX,DEN,14,27,29,5,29,90
4866,Southwest,ATL,BOS,6,38,25,11,15,89
4867,JetBlue,LAX,BOS,15,41,13,11,10,75
4868,American,DFW,PHX,7,3,15,8,6,32
4869,Delta,ATL,BOS,17,44,45,14,6,109
4870,American,ATL,PHX,10,6,10,8,27,51
4871,American,JFK,BOS,4,37,22,8,6,73
4872,JetBlue,LAX,PHX,14,4,46,10,12,72
4873,American,ATL,BOS,10,22,46,9,10,87
4874,JetBlue,ATL,MIA,20,43,21,0,10,74
4875,JetBlue,DFW,SEA,23,25,12,8,18,63
4876,Southwest,DFW,DEN,6,21,48,9,6,84
4877,Delta,ORD,PHX,1,34,54,7,23,118
4878,American,LAX,DEN,5,9,40,5,9,63
4879,Delta,DFW,SEA,8,13,35,10,4,62
4880,Southwest,LAX,BOS,9,56,58,0,3,117
4881,United,ATL,MIA,13,19,1,14,19,53
4882,Delta,LAX,BOS,12,27,21,11,19,78
4883,American,ATL,MIA,23,15,46,14,0,75
4884,Delta,DFW,MIA,6,26,21,0,3,50
4885,United,JFK,MIA,0,39,39,10,23,111
4886,JetBlue,ORD,DEN,6,37,53,3,8,101
4887,United,ATL,MIA,16,44,1,0,18,63
4888,JetBlue,ATL,PHX,23,33,49,4,12,98
4889,American,DFW,PHX,5,32,16,3,0,51
4890,United,ATL,PHX,17,12,17,2,26,57
4891,JetBlue,ORD,PHX,2,21,52,11,24,108
4892,JetBlue,DFW,DEN,8,55,35,3,14,107
4893,Southwest,DFW,PHX,23,7,16,9,23,55
4894,Delta,LAX,SEA,16,22,44,1,20,87
4895,Delta,JFK,SEA,20,43,18,1,17,79
4896,Southwest,ORD,DEN,21,18,55,6,27,106
4897,American,ATL,DEN,1,19,18,7,0,44
4898,Southwest,ATL,BOS,3,22,43,12,15,92
4899,American,LAX,MIA,11,32,18,13,13,76
4900,JetBlue,LAX,PHX,8,4,25,3,4,36
4901,United,ATL,MIA,13,28,55,2,1,86
4902,JetBlue,ORD,PHX,3,58,39,4,7,108
4903,JetBlue,ORD,PHX,17,42,15,9,25,91
4904,Delta,LAX,MIA,19,1,51,5,15,72
4905,United,ATL,SEA,11,24,37,10,4,75
4906,American,LAX,DEN,9,31,32,6,15,84
4907,American,DFW,BOS,4,28,9,2,20,59
4908,Delta,ATL,MIA,7,10,46,5,27,88
4909,JetBlue,ATL,BOS,0,11,57,2,21,91
4910,American,LAX,PHX,13,59,33,10,20,122
4911,United,JFK,PHX,3,18,58,1,16,93
4912,JetBlue,JFK,DEN,14,23,35,9,7,74
4913,Delta,LAX,PHX,10,22,51,0,23,96
4914,Southwest,ORD,SEA,20,22,14,14,16,66
4915,United,JFK,BOS,5,47,46,14,7,114
4916,American,LAX,BOS,16,59,3,8,10,80
4917,United,LAX,DEN,14,42,10,9,17,78
4918,American,DFW,MIA,14,23,30,2,9,64
4919,Delta,JFK,BOS,5,21,36,8,20,85
4920,Southwest,ORD,BOS,14,18,35,10,0,63
4921,Delta,DFW,DEN,20,34,15,13,13,75
4922,United,DFW,MIA,13,8,52,1,15,76
4923,Delta,DFW,PHX,4,19,1,9,19,48
4924,United,DFW,SEA,6,55,9,11,23,98
4925,United,ATL,BOS,17,57,21,6,23,107
4926,JetBlue,ORD,DEN,5,59,8,0,10,77
4927,Southwest,LAX,DEN,23,10,15,12,15,52
4928,JetBlue,DFW,BOS,1,0,39,3,3,45
4929,Delta,ORD,MIA,22,31,37,2,23,93
4930,United,DFW,PHX,16,59,31,10,2,102
4931,Delta,LAX,PHX,22,26,51,1,23,101
4932,Southwest,JFK,SEA,17,51,8,13,23,95
4933,United,LAX,MIA,15,24,59,11,23,117
4934,Delta,DFW,SEA,14,3,59,4,8,74
4935,Southwest,ATL,MIA,14,11,19,8,19,57
4936,American,LAX,BOS,14,9,7,12,5,33
4937,JetBlue,JFK,PHX,1,8,32,12,5,57
4938,JetBlue,ORD,BOS,3,58,2,7,3,70
4939,Southwest,ORD,PHX,17,5,24,14,9,52
4940,Southwest,JFK,BOS,0,28,59,13,24,124
4941,JetBlue,JFK,PHX,10,47,36,0,23,106
4942,JetBlue,DFW,MIA,20,25,41,2,5,73
4943,Southwest,LAX,MIA,18,32,56,11,26,125
4944,JetBlue,LAX,PHX,11,36,5,7,4,52
4945,American,LAX,PHX,15,34,12,0,22,68
4946,JetBlue,DFW,SEA,3,51,41,9,10,111
4947,Delta,ATL,PHX,2,56,30,3,16,105
4948,American,ATL,SEA,7,48,39,11,28,126
4949,Southwest,JFK,BOS,4,55,43,10,4,112
4950,Delta,ATL,DEN,22,12,44,14,4,74
4951,United,JFK,DEN,23,46,26,14,16,102
4952,United,ATL,PHX,7,16,41,12,11,80
4953,United,ORD,MIA,20,5,39,7,10,61
4954,JetBlue,ORD,DEN,9,34,31,8,28,101
4955,Delta,ATL,MIA,11,8,16,3,14,41
4956,United,DFW,SEA,2,11,12,2,23,48
4957,American,DFW,DEN,1,42,1,9,23,75
4958,Delta,ORD,BOS,10,54,47,13,24,138
4959,Southwest,DFW,SEA,2,4,26,8,27,65
4960,Southwest,ORD,BOS,2,7,50,4,6,67
4961,American,ORD,SEA,8,54,55,10,13,132
4962,Delta,JFK,PHX,17,17,1,6,24,48
4963,JetBlue,ATL,DEN,12,6,9,4,8,27
4964,Southwest,LAX,DEN,10,6,53,4,5,68
4965,United,ORD,SEA,7,25,45,13,5,88
4966,United,ATL,DEN,23,20,29,1,23,73
4967,Southwest,ATL,MIA,4,27,2,9,29,67
4968,American,DFW,BOS,17,13,33,10,23,79
4969,Southwest,DFW,BOS,11,33,57,0,15,105
4970,American,ATL,SEA,23,18,30,13,0,61
4971,United,LAX,SEA,3,3,30,7,11,51
4972,United,LAX,SEA,11,51,49,6,5,111
4973,Delta,ATL,PHX,7,44,38,7,6,95
4974,Southwest,ORD,PHX,7,48,34,2,25,109
4975,American,DFW,DEN,7,34,48,11,29,122
4976,American,JFK,DEN,3,39,33,1,26,99
4977,American,LAX,SEA,14,44,45,4,7,100
4978,JetBlue,JFK,SEA,10,37,57,14,6,114
4979,Southwest,ORD,DEN,6,56,2,4,1,63
4980,United,LAX,BOS,12,36,4,8,3,51
4981,American,ATL,BOS,21,45,36,8,22,111
4982,Southwest,LAX,DEN,8,1,25,13,8,47
4983,Delta,DFW,BOS,0,30,54,10,16,110
4984,Southwest,ORD,DEN,5,0,48,13,20,81
4985,Delta,ORD,DEN,16,10,32,11,21,74
4986,United,ATL,DEN,6,35,51,13,18,117
4987,JetBlue,DFW,SEA,12,24,14,14,27,79
4988,Delta,JFK,PHX,4,58,28,7,10,103
4989,JetBlue,LAX,DEN,15,28,56,7,20,111
4990,JetBlue,JFK,DEN,19,18,58,13,6,95
4991,Delta,ATL,SEA,14,28,13,13,10,64
4992,Southwest,DFW,DEN,3,59,38,8,11,116
4993,Delta,LAX,DEN,3,1,51,14,1,67
4994,JetBlue,ATL,MIA,20,0,16,7,28,51
4995,United,ATL,SEA,12,58,37,6,25,126
4996,JetBlue,LAX,PHX,15,9,23,1,7,40
4997,JetBlue,LAX,DEN,20,15,11,8,23,57
4998,Southwest,DFW,PHX,21,59,1,0,22,82
4999,JetBlue,ORD,DEN,5,41,16,1,1,59
5000,Delta,DFW,PHX,18,31,49,13,19,112
5001,Delta,LAX,DEN,1,21,54,0,8,83
5002,United,ATL,PHX,10,36,32,0,24,92
5003,JetBlue,ORD,BOS,19,49,29,5,18,101
5004,Delta,LAX,PHX,18,35,40,0,16,91
5005,United,JFK,SEA,16,48,59,0,10,117
5006,American,ORD,DEN,3,51,30,13,27,121
5007,American,JFK,DEN,18,10,42,9,21,82
5008,Southwest,ATL,PHX,9,54,20,13,3,90
5009,United,DFW,PHX,0,13,27,4,0,44
5010,Delta,ATL,DEN,18,1,10,0,19,30
5011,JetBlue,DFW,BOS,8,11,34,5,19,69
5012,Delta,LAX,SEA,1,47,58,12,15,132
5013,JetBlue,ORD,PHX,20,35,50,11,0,96
5014,Southwest,JFK,MIA,4,19,12,6,3,40
5015,Delta,JFK,BOS,13,25,54,0,11,90
5016,JetBlue,ATL,SEA,8,27,34,1,16,78
5017,Delta,ATL,BOS,10,43,7,8,11,69
5018,United,DFW,DEN,5,7,55,1,8,71
5019,JetBlue,DFW,SEA,21,46,28,4,8,86
5020,Delta,ORD,BOS,11,5,27,12,9,53
5021,Delta,ATL,PHX,2,42,24,1,15,82
5022,Southwest,ORD,BOS,15,17,49,5,17,88
5023,JetBlue,DFW,BOS,12,30,14,12,27,83
5024,JetBlue,LAX,MIA,12,58,36,7,16,117
5025,JetBlue,ATL,MIA,12,2,25,11,7,45
5026,JetBlue,LAX,PHX,7,18,0,6,27,51
5027,United,ATL,SEA,11,26,11,3,26,66
5028,American,ORD,SEA,6,0,23,7,23,53
5029,American,JFK,SEA,23,41,55,6,29,131
5030,American,ATL,PHX,1,44,24,1,8,77
5031,Southwest,LAX,BOS,4,33,3,6,21,63
5032,American,DFW,SEA,1,12,9,1,26,48
5033,Delta,ATL,SEA,21,37,13,10,16,76
5034,American,LAX,DEN,20,58,24,8,20,110
5035,American,JFK,DEN,5,16,26,11,10,63
5036,American,JFK,MIA,23,21,48,7,18,94
5037,United,ORD,DEN,12,8,30,10,27,75
5038,Southwest,ORD,DEN,22,53,16,6,16,91
5039,JetBlue,ORD,DEN,1,39,6,5,6,56
5040,Southwest,ORD,MIA,12,13,3,12,18,46
5041,JetBlue,LAX,PHX,20,4,8,12,1,25
5042,United,DFW,BOS,19,42,23,12,7,84
5043,United,ORD,SEA,0,25,54,13,19,111
5044,Delta,JFK,BOS,4,53,0,14,24,91
5045,Delta,ATL,PHX,12,18,39,6,17,80
5046,Southwest,ATL,PHX,10,41,28,11,20,100
5047,JetBlue,ORD,DEN,21,58,34,2,29,123
5048,United,JFK,MIA,14,53,36,4,24,117
5049,Southwest,ORD,MIA,3,24,56,11,12,103
5050,Southwest,ATL,MIA,17,9,43,3,25,80
5051,JetBlue,ORD,MIA,21,24,3,11,21,59
5052,Delta,JFK,PHX,1,42,47,8,25,122
5053,American,DFW,BOS,17,0,33,10,14,57
5054,United,DFW,BOS,14,54,33,3,18,108
5055,United,ATL,SEA,5,14,30,13,9,66
5056,Southwest,DFW,PHX,13,5,0,5,12,22
5057,Southwest,ATL,SEA,3,14,36,10,17,77
5058,United,ORD,BOS,4,22,48,5,23,98
5059,Delta,ATL,MIA,15,39,5,12,10,66
5060,Delta,JFK,BOS,7,3,48,12,3,66
5061,American,DFW,BOS,17,11,28,3,28,70
5062,JetBlue,LAX,PHX,4,19,45,12,16,92
5063,Southwest,ORD,MIA,13,57,3,12,23,95
5064,Southwest,ATL,MIA,14,44,27,6,8,85
5065,Delta,DFW,PHX,8,8,47,6,20,81
5066,Delta,ORD,BOS,7,22,38,4,18,82
5067,Southwest,DFW,DEN,16,38,55,3,25,121
5068,JetBlue,ORD,MIA,14,58,16,2,29,105
5069,United,JFK,MIA,17,43,24,2,7,76
5070,United,JFK,MIA,0,7,45,5,10,67
5071,Southwest,ORD,PHX,23,26,53,2,28,109
5072,Southwest,JFK,MIA,9,35,45,8,8,96
5073,Southwest,JFK,PHX,16,47,8,2,6,63
5074,JetBlue,JFK,PHX,9,43,10,14,14,81
5075,Delta,ATL,SEA,4,18,34,8,7,67
5076,Delta,LAX,PHX,22,26,9,2,12,49
5077,American,LAX,BOS,1,46,44,8,27,125
5078,Delta,LAX,BOS,8,58,2,1,14,75
5079,JetBlue,ORD,SEA,1,49,38,0,24,111
5080,Southwest,ORD,SEA,1,37,1,8,17,63
5081,American,ORD,DEN,0,58,5,9,25,97
5082,United,ATL,BOS,2,35,0,11,13,59
5083,American,DFW,MIA,21,55,35,1,0,91
5084,JetBlue,LAX,PHX,19,30,59,12,5,106
5085,American,ORD,BOS,11,40,59,10,11,120
5086,JetBlue,ORD,PHX,4,45,14,5,13,77
5087,Southwest,ATL,PHX,17,6,45,14,8,73
5088,Southwest,LAX,MIA,19,57,29,7,11,104
5089,United,ORD,DEN,13,44,15,6,18,83
5090,Southwest,ATL,DEN,15,48,24,3,8,83
5091,United,ORD,DEN,4,44,57,11,23,135
5092,Southwest,DFW,DEN,19,1,25,1,17,44
5093,American,ORD,PHX,7,42,16,11,5,74
5094,JetBlue,ATL,DEN,13,55,48,0,17,120
5095,American,LAX,DEN,16,33,33,12,3,81
5096,Delta,ORD,MIA,20,27,6,9,5,47
5097,United,JFK,BOS,8,29,55,2,3,89
5098,Delta,ORD,SEA,19,58,52,10,5,125
5099,Southwest,ATL,DEN,7,3,55,12,19,89
5100,United,JFK,SEA,22,21,1,6,22,50
5101,United,JFK,DEN,19,30,16,2,17,65
5102,American,ORD,PHX,23,17,17,0,19,53
5103,Delta,ATL,MIA,11,45,25,6,25,101
5104,JetBlue,ORD,DEN,21,44,12,5,27,88
5105,American,LAX,SEA,0,53,41,5,2,101
5106,United,JFK,DEN,3,58,0,3,3,64
5107,United,ATL,PHX,9,44,10,3,10,67
5108,Southwest,ORD,MIA,12,25,3,4,23,55
5109,American,DFW,DEN,3,13,4,6,21,44
5110,American,ATL,SEA,1,40,5,5,16,66
5111,American,JFK,BOS,4,19,46,4,24,93
5112,Southwest,JFK,PHX,13,24,12,9,11,56
5113,JetBlue,JFK,SEA,13,51,7,10,27,95
5114,Delta,ORD,DEN,9,35,31,6,25,97
5115,JetBlue,ORD,MIA,5,20,29,9,9,67
5116,JetBlue,LAX,PHX,0,37,8,10,27,82
5117,Delta,LAX,SEA,22,35,10,11,13,69
5118,American,ORD,MIA,10,47,40,12,26,125
5119,United,ATL,SEA,10,23,56,14,29,122
5120,United,LAX,MIA,1,44,45,8,0,97
5121,JetBlue,DFW,MIA,18,8,27,12,26,73
5122,Delta,ORD,MIA,15,26,59,11,18,114
5123,United,ATL,MIA,6,33,39,13,20,105
5124,United,JFK,MIA,21,23,29,4,17,73
5125,United,DFW,BOS,17,9,53,4,16,82
5126,United,LAX,MIA,0,51,4,11,6,72
5127,United,JFK,BOS,20,22,20,12,14,68
5128,Southwest,JFK,PHX,23,23,22,0,0,45
5129,JetBlue,ATL,SEA,7,7,10,0,22,39
5130,American,JFK,MIA,0,12,34,7,5,58
5131,Delta,ORD,DEN,20,42,26,8,15,91
5132,JetBlue,ATL,SEA,8,54,31,5,2,92
5133,Southwest,ORD,SEA,15,8,22,0,23,53
5134,United,DFW,DEN,13,41,34,0,7,82
5135,JetBlue,LAX,MIA,0,1,43,11,29,84
5136,Delta,DFW,DEN,21,25,27,11,14,77
5137,United,ORD,DEN,15,39,26,11,13,89
5138,Southwest,ORD,MIA,1,52,0,0,9,61
5139,Southwest,JFK,DEN,3,0,55,12,9,76
5140,JetBlue,DFW,SEA,7,0,9,1,4,14
5141,United,ATL,DEN,16,5,40,0,21,66
5142,JetBlue,LAX,SEA,7,38,7,13,12,70
5143,Southwest,ATL,BOS,8,43,0,12,21,76
5144,Delta,JFK,SEA,16,31,41,14,10,96
5145,JetBlue,DFW,SEA,19,55,17,1,26,99
5146,Southwest,LAX,PHX,9,7,49,14,3,73
5147,American,ORD,BOS,1,15,15,13,16,59
5148,United,JFK,MIA,19,0,15,6,13,34
5149,United,JFK,SEA,1,23,2,11,14,50
5150,Southwest,LAX,SEA,20,51,30,6,10,97
5151,Southwest,ORD,BOS,23,5,40,5,0,50
5152,JetBlue,JFK,DEN,10,37,28,8,21,94
5153,Southwest,ORD,MIA,4,10,54,2,7,73
5154,United,DFW,DEN,13,56,26,7,2,91
5155,Southwest,DFW,SEA,4,6,53,11,8,78
5156,Delta,DFW,PHX,21,35,28,5,25,93
5157,Southwest,DFW,DEN,10,53,1,1,6,61
5158,American,JFK,DEN,17,27,17,5,24,73
5159,American,ATL,MIA,5,20,59,6,8,93
5160,Delta,ORD,SEA,23,30,5,2,1,38
5161,United,DFW,PHX,5,58,38,2,22,120
5162,American,ATL,MIA,6,29,11,8,0,48
5163,American,ATL,DEN,3,26,26,5,26,83
5164,Southwest,JFK,PHX,2,24,6,12,26,68
5165,Southwest,JFK,MIA,7,53,45,9,8,115
5166,American,JFK,BOS,4,13,37,7,4,61
5167,United,DFW,SEA,17,41,28,1,7,77
5168,American,DFW,SEA,4,52,52,9,25,138
5169,JetBlue,JFK,DEN,1,21,45,5,5,76
5170,United,DFW,DEN,13,0,5,12,13,30
5171,Southwest,ORD,MIA,14,17,46,7,1,71
5172,American,DFW,DEN,10,0,9,8,1,18
5173,Delta,ORD,BOS,23,8,36,10,15,69
5174,JetBlue,ORD,PHX,17,2,32,6,21,61
5175,Delta,DFW,MIA,0,27,3,10,6,46
5176,United,LAX,PHX,13,53,13,8,28,102
5177,United,DFW,DEN,0,7,19,9,1,36
5178,Southwest,DFW,BOS,23,4,29,3,8,44
5179,Southwest,JFK,MIA,0,27,10,1,18,56
5180,Southwest,ORD,BOS,22,36,46,1,18,101
5181,American,JFK,SEA,13,54,28,12,27,121
5182,JetBlue,JFK,PHX,19,15,21,5,24,65
5183,United,LAX,DEN,23,0,53,5,29,87
5184,JetBlue,DFW,BOS,14,35,22,4,16,77
5185,United,ORD,BOS,12,22,5,3,25,55
5186,JetBlue,ORD,MIA,14,9,4,7,25,45
5187,JetBlue,ORD,PHX,2,48,23,3,21,95
5188,Delta,ATL,DEN,12,13,7,5,12,37
5189,JetBlue,ORD,MIA,9,59,39,10,5,113
5190,American,LAX,BOS,18,44,14,11,26,95
5191,JetBlue,LAX,PHX,17,58,19,3,20,100
5192,Delta,ATL,SEA,1,4,53,12,21,90
5193,Southwest,ORD,BOS,7,41,53,13,26,133
5194,Delta,ORD,DEN,23,12,22,14,19,67
5195,Delta,DFW,DEN,6,5,22,10,26,63
5196,American,DFW,BOS,23,33,8,10,5,56
5197,Southwest,DFW,SEA,15,33,0,14,2,49
5198,United,DFW,SEA,11,51,6,8,9,74
5199,United,DFW,PHX,14,58,11,1,18,88
5200,JetBlue,ATL,MIA,9,50,32,11,26,119
5201,United,ATL,MIA,19,50,2,11,22,85
5202,American,ORD,DEN,1,54,18,8,10,90
5203,Southwest,ATL,PHX,5,13,6,2,14,35
5204,American,DFW,PHX,15,52,25,4,10,91
5205,American,LAX,DEN,17,29,53,9,0,91
5206,American,JFK,SEA,21,17,41,7,29,94
5207,JetBlue,LAX,BOS,9,45,31,13,2,91
5208,Southwest,ATL,BOS,19,32,3,6,24,65
5209,Southwest,ORD,SEA,1,27,43,11,15,96
5210,JetBlue,LAX,BOS,17,21,17,5,6,49
5211,JetBlue,LAX,SEA,18,13,21,9,1,44
5212,American,JFK,BOS,0,57,2,1,17,77
5213,United,DFW,MIA,0,26,11,3,7,47
5214,Southwest,JFK,DEN,19,2,21,7,26,56
5215,Delta,DFW,BOS,3,46,37,4,1,88
5216,Southwest,JFK,BOS,11,6,49,11,14,80
5217,JetBlue,LAX,PHX,0,37,50,13,24,124
5218,JetBlue,LAX,DEN,6,25,55,14,5,99
5219,JetBlue,ORD,BOS,0,21,9,10,8,48
5220,Delta,ATL,PHX,10,46,58,9,17,130
5221,Delta,LAX,SEA,14,10,17,7,6,40
5222,Southwest,ORD,DEN,10,41,32,7,23,103
5223,Delta,ORD,BOS,12,51,25,4,22,102
5224,Southwest,LAX,SEA,13,32,33,14,6,85
5225,JetBlue,ORD,BOS,22,48,50,1,23,122
5226,JetBlue,LAX,SEA,10,35,7,2,3,47
5227,JetBlue,ATL,SEA,14,23,46,4,26,99
5228,Southwest,ATL,DEN,17,29,57,11,18,115
5229,Delta,JFK,BOS,17,25,10,14,14,63
5230,JetBlue,ORD,SEA,6,34,52,5,22,113
5231,American,JFK,BOS,15,59,57,4,21,141
5232,JetBlue,JFK,SEA,8,47,43,7,25,122
5233,JetBlue,ORD,BOS,0,42,30,13,15,100
5234,American,ORD,MIA,20,4,24,2,11,41
5235,Southwest,LAX,BOS,13,1,0,1,12,14
5236,Southwest,DFW,PHX,3,18,45,7,14,84
5237,Southwest,ORD,BOS,14,58,30,13,16,117
5238,Southwest,ORD,MIA,12,13,29,5,25,72
5239,American,ATL,DEN,4,36,20,5,29,90
5240,American,LAX,MIA,0,43,1,4,17,65
5241,Delta,ATL,DEN,9,49,25,12,12,98
5242,American,ORD,BOS,12,35,14,11,16,76
5243,Delta,DFW,DEN,1,31,15,14,12,72
5244,Delta,LAX,MIA,18,19,36,8,4,67
5245,Southwest,ATL,DEN,4,5,57,3,10,75
5246,United,ORD,BOS,9,39,33,4,4,80
5247,JetBlue,JFK,DEN,1,49,30,14,1,94
5248,American,DFW,DEN,14,39,17,6,9,71
5249,Southwest,DFW,PHX,17,23,28,10,25,86
5250,Delta,LAX,SEA,20,13,41,0,17,71
5251,Delta,ATL,PHX,14,17,25,9,18,69
5252,American,ORD,PHX,12,55,59,1,29,144
5253,United,ATL,BOS,20,3,0,1,9,13
5254,JetBlue,ATL,DEN,14,33,19,9,28,89
5255,Southwest,DFW,MIA,11,49,51,5,8,113
5256,JetBlue,JFK,BOS,22,5,2,0,22,29
5257,United,DFW,BOS,23,50,30,0,19,99
5258,American,LAX,BOS,10,33,0,1,18,52
5259,American,ORD,DEN,19,22,37,13,7,79
5260,United,ATL,PHX,3,5,17,14,21,57
5261,Southwest,DFW,MIA,14,53,48,5,21,127
5262,Delta,JFK,BOS,1,50,1,2,24,77
5263,Delta,DFW,DEN,21,16,50,8,23,97
5264,Southwest,LAX,MIA,11,4,44,2,8,58
5265,Southwest,DFW,PHX,20,21,43,12,6,82
5266,Delta,DFW,BOS,0,47,39,11,21,118
5267,American,JFK,SEA,15,39,16,7,5,67
5268,JetBlue,ORD,SEA,0,30,17,1,11,59
5269,United,JFK,BOS,6,46,15,7,18,86
5270,American,DFW,BOS,6,52,12,1,22,87
5271,JetBlue,DFW,DEN,8,31,4,10,11,56
5272,Southwest,JFK,BOS,2,35,6,6,3,50
5273,American,JFK,BOS,2,51,10,9,28,98
5274,JetBlue,ORD,PHX,10,48,54,8,20,130
5275,United,ORD,BOS,14,41,0,4,29,74
5276,Southwest,LAX,BOS,7,55,31,11,14,111
5277,Delta,LAX,BOS,3,0,7,8,1,16
5278,Southwest,DFW,MIA,15,17,0,10,9,36
5279,JetBlue,DFW,SEA,19,22,11,3,3,39
5280,United,ATL,DEN,7,55,20,10,16,101
5281,JetBlue,DFW,MIA,0,15,15,2,14,46
5282,United,DFW,PHX,23,5,30,6,18,59
5283,Delta,ORD,PHX,14,19,57,3,18,97
5284,American,DFW,DEN,15,22,42,10,10,84
5285,American,ATL,DEN,13,34,57,14,7,112
5286,JetBlue,ORD,MIA,4,28,9,3,7,47
5287,JetBlue,ORD,PHX,4,2,55,1,21,79
5288,Delta,DFW,BOS,12,41,31,0,20,92
5289,American,ATL,PHX,23,46,1,7,4,58
5290,Delta,LAX,SEA,5,39,39,5,21,104
5291,American,DFW,PHX,16,3,52,1,13,69
5292,United,LAX,DEN,15,23,19,13,15,70
5293,Southwest,LAX,BOS,1,38,30,2,21,91
5294,Southwest,LAX,SEA,11,14,43,0,25,82
5295,United,JFK,DEN,9,9,14,3,2,28
5296,Delta,LAX,PHX,4,16,17,9,5,47
5297,Delta,ORD,BOS,7,37,0,11,25,73
5298,Southwest,ATL,PHX,16,37,24,1,13,75
5299,Southwest,ATL,SEA,15,48,47,6,25,126
5300,United,LAX,PHX,17,45,59,3,23,130
5301,JetBlue,DFW,PHX,0,50,0,0,16,66
5302,Delta,JFK,PHX,14,51,57,5,19,132
5303,United,DFW,PHX,17,37,16,13,0,66
5304,JetBlue,ORD,PHX,14,48,5,5,1,59
5305,American,ORD,SEA,11,36,20,7,10,73
5306,United,LAX,MIA,8,9,56,7,24,96
5307,American,JFK,PHX,19,11,37,3,17,68
5308,Delta,JFK,SEA,18,46,44,1,0,91
5309,United,JFK,SEA,21,5,57,10,19,91
5310,Southwest,LAX,DEN,1,18,49,11,26,104
5311,Southwest,ATL,BOS,22,52,7,11,9,79
5312,JetBlue,LAX,MIA,4,38,41,11,2,92
5313,JetBlue,JFK,MIA,7,17,7,0,25,49
5314,JetBlue,JFK,BOS,19,1,11,2,23,37
5315,United,DFW,BOS,15,50,24,0,2,76
5316,Southwest,ATL,PHX,10,58,23,9,18,108
5317,United,DFW,DEN,18,37,34,9,0,80
5318,American,JFK,BOS,5,24,36,7,24,91
5319,JetBlue,ATL,MIA,16,26,35,9,26,96
5320,JetBlue,JFK,SEA,5,58,30,8,11,107
5321,American,JFK,DEN,21,5,2,4,16,27
5322,JetBlue,DFW,BOS,19,23,8,1,3,35
5323,United,DFW,MIA,5,51,9,1,10,71
5324,American,ATL,PHX,17,5,40,8,4,57
5325,United,ATL,DEN,8,51,16,2,22,91
5326,JetBlue,LAX,DEN,13,12,4,0,7,23
5327,United,ATL,SEA,22,48,19,14,20,101
5328,United,DFW,BOS,0,56,45,5,23,129
5329,United,ORD,BOS,21,33,31,7,1,72
5330,American,ORD,PHX,14,35,11,9,27,82
5331,American,ATL,SEA,6,5,38,8,9,60
5332,United,ATL,SEA,23,57,31,13,8,109
5333,United,ORD,DEN,21,12,49,10,15,86
5334,Southwest,ATL,MIA,19,20,8,8,3,39
5335,JetBlue,ORD,SEA,7,45,39,8,1,93
5336,American,LAX,SEA,1,17,17,7,20,61
5337,Southwest,ORD,DEN,23,38,4,14,20,76
5338,United,LAX,PHX,1,5,41,14,19,79
5339,American,ORD,PHX,21,48,5,0,15,68
5340,American,ORD,MIA,21,4,12,1,5,22
5341,American,ORD,PHX,13,50,39,12,20,121
5342,Southwest,LAX,SEA,7,36,29,9,12,86
5343,American,ORD,BOS,18,13,32,1,28,74
5344,United,ORD,SEA,4,21,17,5,2,45
5345,Southwest,JFK,DEN,2,24,33,0,0,57
5346,JetBlue,JFK,DEN,15,38,19,9,3,69
5347,American,ORD,PHX,1,52,1,6,20,79
5348,United,DFW,SEA,1,57,0,7,26,90
5349,Delta,LAX,DEN,22,28,57,13,0,98
5350,JetBlue,LAX,BOS,17,38,18,11,0,67
5351,United,LAX,SEA,8,42,35,13,16,106
5352,Delta,ATL,SEA,3,29,57,0,5,91
5353,American,ATL,MIA,13,53,57,14,15,139
5354,United,LAX,SEA,19,45,56,12,13,126
5355,JetBlue,DFW,SEA,1,46,59,14,21,140
5356,United,DFW,SEA,3,50,12,13,2,77
5357,United,ORD,MIA,21,12,58,6,29,105
5358,JetBlue,ATL,DEN,17,32,31,1,14,78
5359,JetBlue,ORD,SEA,22,42,18,6,16,82
5360,JetBlue,ORD,SEA,22,17,54,1,26,98
5361,Delta,ORD,PHX,20,12,43,4,0,59
5362,United,DFW,MIA,9,59,16,3,29,107
5363,Southwest,ATL,SEA,14,28,35,7,8,78
5364,JetBlue,ATL,SEA,14,2,27,10,28,67
5365,American,JFK,BOS,14,57,32,0,19,108
5366,Delta,ORD,BOS,7,48,0,7,19,74
5367,United,DFW,PHX,11,9,3,13,28,53
5368,Southwest,ATL,DEN,4,0,40,0,9,49
5369,Southwest,LAX,MIA,6,34,56,6,11,107
5370,United,JFK,BOS,0,51,6,7,28,92
5371,American,LAX,DEN,22,10,37,13,23,83
5372,United,DFW,DEN,16,42,37,8,14,101
5373,Southwest,JFK,BOS,15,15,46,8,2,71
5374,Delta,DFW,SEA,8,31,24,12,12,79
5375,Southwest,ATL,SEA,21,19,36,0,4,59
5376,Southwest,JFK,PHX,18,16,33,14,21,84
5377,JetBlue,JFK,BOS,13,39,55,10,9,113
5378,United,LAX,SEA,0,42,19,2,9,72
5379,American,ATL,PHX,22,43,52,10,0,105
5380,United,ATL,BOS,21,57,0,8,3,68
5381,American,DFW,PHX,3,49,55,7,1,112
5382,Delta,DFW,BOS,12,49,26,10,4,89
5383,Southwest,LAX,SEA,4,32,10,2,18,62
5384,United,DFW,SEA,8,57,47,1,1,106
5385,American,JFK,DEN,16,2,14,9,25,50
5386,Southwest,ATL,BOS,0,3,37,0,5,45
5387,JetBlue,JFK,SEA,9,3,17,10,5,35
5388,Delta,ATL,DEN,20,55,32,12,7,106
5389,United,DFW,DEN,18,11,22,9,13,55
5390,JetBlue,DFW,DEN,2,43,11,14,7,75
5391,Southwest,JFK,MIA,1,35,12,8,10,65
5392,Delta,JFK,PHX,16,39,40,1,11,91
5393,JetBlue,ATL,DEN,9,44,49,7,26,126
5394,Southwest,LAX,MIA,22,30,15,4,10,59
5395,Southwest,ATL,BOS,0,25,41,11,17,94
5396,United,ATL,PHX,2,0,21,12,17,50
5397,JetBlue,DFW,DEN,8,36,19,10,25,90
5398,United,LAX,BOS,23,9,30,14,2,55
5399,JetBlue,DFW,PHX,6,31,54,10,4,99
5400,United,JFK,MIA,5,19,9,2,12,42
5401,United,ORD,BOS,21,0,53,13,10,76
5402,Southwest,DFW,BOS,7,42,37,7,23,109
5403,Southwest,JFK,BOS,22,46,17,12,21,96
5404,American,LAX,BOS,1,41,42,3,3,89
5405,American,JFK,PHX,20,58,46,11,14,129
5406,Delta,DFW,SEA,15,22,37,14,15,88
5407,United,LAX,MIA,2,2,53,8,2,65
5408,American,JFK,MIA,11,59,36,10,4,109
5409,Delta,ORD,SEA,20,34,49,1,9,93
5410,American,DFW,MIA,6,3,27,4,12,46
5411,Southwest,ATL,DEN,23,52,59,13,14,138
5412,American,JFK,MIA,23,32,16,10,28,86
5413,JetBlue,LAX,SEA,13,17,31,0,13,61
5414,Southwest,ORD,MIA,23,0,15,5,6,26
5415,American,JFK,DEN,8,14,44,5,17,80
5416,American,ORD,SEA,1,25,18,7,28,78
5417,United,DFW,MIA,15,35,10,7,25,77
5418,JetBlue,JFK,MIA,0,18,0,7,18,43
5419,Southwest,JFK,PHX,22,59,7,7,16,89
5420,United,ATL,DEN,2,11,42,12,4,69
5421,United,ORD,SEA,23,20,23,10,1,54
5422,Southwest,LAX,SEA,17,30,41,0,23,94
5423,American,LAX,BOS,0,45,8,13,16,82
5424,JetBlue,JFK,MIA,20,22,6,5,5,38
5425,United,LAX,DEN,18,27,48,12,1,88
5426,JetBlue,DFW,SEA,6,54,17,12,25,108
5427,American,DFW,MIA,2,34,40,7,9,90
5428,American,JFK,DEN,10,26,40,6,22,94
5429,JetBlue,DFW,SEA,18,22,56,12,17,107
5430,Southwest,ATL,PHX,19,16,18,11,16,61
5431,American,DFW,DEN,20,30,30,12,13,85
5432,American,ATL,SEA,9,52,17,13,17,99
5433,American,JFK,MIA,10,33,3,13,10,59
5434,American,ORD,SEA,16,55,35,1,27,118
5435,Delta,DFW,SEA,0,10,38,12,6,66
5436,JetBlue,DFW,SEA,14,11,30,1,24,66
5437,American,JFK,MIA,16,31,38,13,6,88
5438,Delta,LAX,BOS,14,44,54,8,11,117
5439,Southwest,JFK,PHX,2,56,21,10,26,113
5440,Delta,ATL,BOS,20,45,33,5,22,105
5441,JetBlue,JFK,DEN,17,52,6,13,8,79
5442,JetBlue,DFW,PHX,8,10,37,3,20,70
5443,Southwest,LAX,PHX,23,4,51,11,9,75
5444,American,LAX,BOS,13,41,57,14,17,129
5445,JetBlue,ATL,BOS,12,19,1,4,1,25
5446,Delta,JFK,MIA,7,10,45,5,17,77
5447,Delta,ATL,MIA,14,28,33,8,28,97
5448,American,ATL,DEN,22,1,33,0,4,38
5449,Delta,ORD,BOS,6,7,41,6,13,67
5450,United,JFK,SEA,11,41,4,13,9,67
5451,Southwest,JFK,PHX,8,3,9,14,5,31
5452,Southwest,ORD,MIA,9,23,31,12,21,87
5453,Southwest,LAX,SEA,16,7,30,4,29,70
5454,JetBlue,DFW,SEA,7,29,52,5,15,101
5455,JetBlue,ATL,BOS,20,31,19,6,2,58
5456,Southwest,ATL,DEN,1,21,39,1,6,67
5457,Southwest,DFW,MIA,14,6,41,9,9,65
5458,Southwest,ATL,DEN,20,42,23,1,9,75
5459,JetBlue,JFK,DEN,9,21,17,10,14,62
5460,American,ATL,MIA,9,24,55,10,14,103
5461,JetBlue,ORD,MIA,1,55,28,12,20,115
5462,American,ATL,MIA,22,49,23,6,23,101
5463,Southwest,LAX,DEN,3,15,41,8,9,73
5464,United,JFK,PHX,19,41,18,4,24,87
5465,Southwest,JFK,PHX,0,51,59,9,12,131
5466,Delta,DFW,SEA,22,36,20,2,0,58
5467,Southwest,ATL,DEN,3,5,7,13,13,38
5468,United,ATL,DEN,13,44,31,6,28,109
5469,American,JFK,PHX,19,48,26,7,7,88
5470,Delta,LAX,DEN,5,57,59,11,9,136
5471,Southwest,DFW,BOS,23,5,0,3,29,37
5472,Delta,LAX,BOS,2,53,34,14,23,124
5473,American,JFK,SEA,5,42,53,3,13,111
5474,Southwest,ORD,SEA,22,35,33,3,1,72
5475,Southwest,ORD,BOS,12,40,13,5,6,64
5476,JetBlue,DFW,MIA,5,54,57,3,14,128
5477,JetBlue,LAX,MIA,17,56,34,4,22,116
5478,Southwest,ORD,BOS,2,5,23,2,16,46
5479,United,ATL,MIA,8,34,35,1,18,88
5480,Southwest,ATL,SEA,8,33,49,14,14,110
5481,United,ORD,SEA,4,51,35,6,9,101
5482,Southwest,DFW,BOS,0,41,38,8,0,87
5483,Delta,ATL,BOS,1,8,35,3,19,65
5484,Southwest,DFW,MIA,11,15,58,7,0,80
5485,United,LAX,PHX,17,0,0,9,26,35
5486,Delta,LAX,PHX,22,29,47,4,4,84
5487,Delta,DFW,BOS,13,52,25,7,16,100
5488,JetBlue,LAX,DEN,8,57,17,5,7,86
5489,Southwest,ATL,DEN,9,47,26,4,19,96
5490,Southwest,ATL,PHX,20,7,42,5,6,60
5491,Delta,DFW,BOS,18,27,9,14,15,65
5492,Southwest,LAX,PHX,8,47,36,5,19,107
5493,Delta,DFW,MIA,3,32,53,2,29,116
5494,American,LAX,PHX,1,9,20,14,2,45
5495,Southwest,DFW,DEN,23,54,33,14,23,124
5496,JetBlue,JFK,PHX,4,3,26,5,10,44
5497,American,LAX,MIA,14,35,20,3,19,77
5498,United,JFK,DEN,11,49,23,13,15,100
5499,American,ATL,SEA,20,59,15,11,23,108
5500,Delta,ORD,BOS,16,35,44,8,24,111
5501,Southwest,DFW,DEN,5,10,1,1,29,41
5502,Delta,DFW,DEN,5,13,38,13,16,80
5503,American,DFW,SEA,6,13,40,6,17,76
5504,Southwest,LAX,BOS,7,37,57,13,17,124
5505,American,ORD,BOS,5,52,32,13,1,98
5506,Southwest,LAX,MIA,2,54,52,9,15,130
5507,Southwest,ATL,PHX,21,18,37,2,8,65
5508,Southwest,JFK,BOS,13,13,6,5,9,33
5509,JetBlue,LAX,SEA,7,9,2,12,15,38
5510,Southwest,DFW,PHX,22,3,9,14,27,53
5511,Delta,ORD,SEA,17,45,0,2,12,59
5512,American,JFK,DEN,12,32,55,8,15,110
5513,Delta,LAX,SEA,16,3,8,13,23,47
5514,Delta,ATL,MIA,4,5,19,3,13,40
5515,American,DFW,PHX,11,35,26,10,16,87
5516,American,DFW,PHX,12,39,41,5,26,111
5517,United,ATL,MIA,21,20,13,0,19,52
5518,United,ORD,PHX,17,15,21,7,10,53
5519,American,ATL,MIA,21,33,31,1,15,80
5520,Delta,DFW,SEA,0,46,6,0,11,63
5521,Delta,ATL,DEN,23,48,59,13,17,137
5522,JetBlue,LAX,SEA,6,15,3,2,21,41
5523,United,ORD,DEN,20,56,4,10,23,93
5524,Delta,LAX,SEA,20,21,34,2,12,69
5525,Southwest,JFK,BOS,1,29,22,6,17,74
5526,United,LAX,PHX,0,23,48,4,1,76
5527,United,ORD,PHX,9,14,28,14,24,80
5528,Southwest,ATL,BOS,15,5,9,7,28,49
5529,American,ORD,PHX,17,33,55,4,21,113
5530,JetBlue,LAX,MIA,0,21,59,11,17,108
5531,United,ORD,DEN,3,45,56,11,28,140
5532,Southwest,JFK,MIA,9,0,4,8,22,34
5533,JetBlue,ORD,SEA,19,14,44,2,7,67
5534,American,LAX,PHX,21,5,59,12,19,95
5535,United,LAX,BOS,16,30,56,14,29,129
5536,JetBlue,ATL,SEA,0,56,6,4,14,80
5537,American,ORD,PHX,2,9,13,0,11,33
5538,United,JFK,MIA,6,55,48,9,27,139
5539,United,DFW,MIA,13,25,26,6,8,65
5540,Southwest,LAX,BOS,19,51,58,5,8,122
5541,Delta,ORD,SEA,18,3,49,13,27,92
5542,American,LAX,MIA,19,37,30,5,26,98
5543,Southwest,ATL,BOS,17,37,46,6,13,102
5544,Delta,ORD,PHX,3,54,11,5,18,88
5545,Delta,ORD,BOS,6,42,48,14,29,133
5546,Delta,ORD,DEN,11,6,39,5,12,62
5547,Delta,ATL,MIA,11,20,29,1,13,63
5548,United,LAX,DEN,19,4,58,5,27,94
5549,JetBlue,LAX,MIA,19,18,57,0,25,100
5550,JetBlue,JFK,PHX,14,44,43,0,12,99
5551,American,DFW,DEN,10,34,18,8,29,89
5552,JetBlue,JFK,SEA,13,0,52,1,6,59
5553,United,ATL,MIA,20,13,23,3,6,45
5554,JetBlue,LAX,PHX,6,44,31,8,12,95
5555,Southwest,ORD,DEN,15,45,51,14,10,120
5556,United,ORD,BOS,6,11,55,6,4,76
5557,United,DFW,SEA,2,56,46,1,20,123
5558,Southwest,JFK,SEA,23,22,43,13,15,93
5559,United,JFK,MIA,22,6,23,5,17,51
5560,United,ORD,PHX,0,24,18,7,26,75
5561,American,ATL,MIA,11,0,14,0,15,29
5562,United,ATL,SEA,3,56,50,8,21,135
5563,United,ATL,SEA,15,42,5,11,14,72
5564,United,ORD,BOS,18,26,46,11,15,98
5565,United,LAX,BOS,5,10,53,13,18,94
5566,United,ATL,SEA,9,37,39,3,7,86
5567,Southwest,LAX,SEA,22,40,17,1,11,69
5568,American,ORD,PHX,17,56,37,8,11,112
5569,American,LAX,PHX,7,46,39,9,0,94
5570,United,DFW,PHX,9,8,56,5,19,88
5571,American,DFW,BOS,0,15,41,14,15,85
5572,American,LAX,PHX,17,18,21,0,22,61
5573,United,ORD,SEA,16,19,58,2,10,89
5574,Southwest,ATL,PHX,1,10,18,12,13,53
5575,Delta,LAX,PHX,3,23,18,5,7,53
5576,JetBlue,DFW,DEN,5,1,1,3,21,26
5577,JetBlue,LAX,DEN,5,16,48,2,16,82
5578,JetBlue,ORD,SEA,18,48,52,10,7,117
5579,United,ORD,BOS,5,28,21,8,13,70
5580,Delta,LAX,BOS,7,31,1,13,2,47
5581,United,ORD,MIA,16,0,53,11,13,77
5582,American,ATL,BOS,1,46,22,10,27,105
5583,Southwest,ORD,DEN,2,10,47,0,9,66
5584,Southwest,JFK,PHX,23,36,18,3,3,60
5585,United,DFW,BOS,4,3,2,0,17,22
5586,Delta,ORD,MIA,15,26,8,11,4,49
5587,United,DFW,DEN,19,42,23,7,29,101
5588,United,DFW,MIA,5,30,46,2,25,103
5589,Southwest,JFK,BOS,1,13,25,2,28,68
5590,Southwest,ORD,BOS,11,45,45,0,23,113
5591,American,ATL,SEA,17,1,31,10,20,62
5592,Southwest,DFW,SEA,19,46,13,5,8,72
5593,American,LAX,MIA,10,10,38,7,1,56
5594,United,LAX,SEA,4,28,4,8,20,60
5595,American,ORD,PHX,7,0,31,8,29,68
5596,Southwest,LAX,PHX,5,59,13,12,20,104
5597,Southwest,JFK,DEN,22,19,38,6,29,92
5598,JetBlue,DFW,BOS,21,5,20,3,4,32
5599,Southwest,ATL,MIA,6,15,49,0,25,89
5600,Delta,JFK,BOS,2,30,40,13,5,88
5601,Delta,ATL,BOS,1,29,18,9,8,64
5602,JetBlue,ATL,MIA,14,48,26,5,1,80
5603,Delta,ATL,MIA,13,53,4,4,15,76
5604,Delta,JFK,BOS,9,29,21,13,11,74
5605,Southwest,ATL,BOS,23,0,29,13,23,65
5606,United,DFW,MIA,23,15,34,7,4,60
5607,Southwest,ATL,SEA,15,44,18,9,0,71
5608,United,ATL,SEA,19,22,52,10,25,109
5609,Delta,LAX,PHX,1,30,18,13,24,85
5610,Delta,JFK,SEA,6,57,53,12,20,142
5611,American,ORD,SEA,2,35,25,5,8,73
5612,JetBlue,ATL,PHX,14,38,37,4,19,98
5613,Delta,ATL,BOS,14,29,23,13,15,80
5614,Southwest,ATL,SEA,5,21,34,5,3,63
5615,United,ATL,DEN,9,58,3,1,12,74
5616,JetBlue,JFK,SEA,1,53,38,14,14,119
5617,JetBlue,LAX,MIA,20,16,4,5,0,25
5618,United,DFW,PHX,14,15,16,3,17,51
5619,Southwest,ORD,DEN,0,53,16,5,20,94
5620,American,LAX,DEN,6,38,4,5,26,73
5621,United,ORD,SEA,15,58,42,6,1,107
5622,United,ATL,DEN,10,45,30,1,6,82
5623,United,ATL,PHX,8,19,52,12,12,95
5624,JetBlue,DFW,MIA,12,55,18,0,12,85
5625,Delta,ATL,BOS,0,0,12,14,20,46
5626,Southwest,JFK,DEN,16,24,59,7,1,91
5627,American,ORD,MIA,6,40,40,1,23,104
5628,Southwest,LAX,PHX,3,0,11,7,23,41
5629,JetBlue,LAX,BOS,19,4,55,10,25,94
5630,JetBlue,ORD,SEA,9,39,15,14,21,89
5631,United,ORD,MIA,4,37,37,6,13,93
5632,United,ATL,PHX,19,23,59,11,19,112
5633,American,ATL,MIA,8,26,17,9,26,78
5634,JetBlue,ORD,DEN,3,4,19,11,23,57
5635,United,LAX,PHX,12,44,33,10,28,115
5636,United,DFW,DEN,20,26,1,9,28,64
5637,JetBlue,JFK,PHX,14,44,9,14,20,87
5638,Southwest,ATL,BOS,3,58,36,3,29,126
5639,United,ORD,PHX,3,9,11,2,24,46
5640,Delta,DFW,DEN,2,41,5,8,16,70
5641,American,LAX,MIA,10,24,26,2,7,59
5642,Southwest,JFK,SEA,16,36,23,10,4,73
5643,United,DFW,MIA,9,18,32,12,6,68
5644,United,ORD,PHX,5,42,7,12,8,69
5645,Delta,ATL,PHX,13,35,55,7,6,103
5646,American,LAX,SEA,23,34,23,12,2,71
5647,United,DFW,PHX,12,34,48,11,27,120
5648,Southwest,ATL,MIA,14,23,22,7,24,76
5649,JetBlue,ATL,DEN,11,39,15,12,17,83
5650,Southwest,DFW,MIA,22,40,18,9,24,91
5651,Delta,ATL,PHX,18,41,5,7,0,53
5652,Southwest,JFK,SEA,22,21,17,14,11,63
5653,United,DFW,PHX,18,54,59,13,14,140
5654,American,JFK,PHX,2,16,36,9,10,71
5655,Southwest,LAX,MIA,2,25,45,9,26,105
5656,Delta,JFK,BOS,3,47,18,7,0,72
5657,Delta,ORD,PHX,2,12,50,6,3,71
5658,JetBlue,JFK,MIA,1,17,0,8,3,28
5659,Delta,JFK,BOS,3,52,47,13,14,126
5660,American,DFW,BOS,10,28,20,12,24,84
5661,Delta,DFW,BOS,12,46,37,8,27,118
5662,Delta,ATL,DEN,22,51,35,3,22,111
5663,United,DFW,SEA,4,29,57,8,0,94
5664,United,DFW,BOS,16,51,37,1,4,93
5665,United,JFK,MIA,22,16,50,7,29,102
5666,Delta,DFW,SEA,3,38,5,9,7,59
5667,American,JFK,MIA,11,28,38,5,25,96
5668,United,ATL,SEA,11,8,46,3,6,63
5669,Southwest,DFW,MIA,10,25,41,4,1,71
5670,American,LAX,PHX,23,18,1,2,20,41
5671,Delta,ATL,SEA,23,36,45,8,1,90
5672,American,JFK,SEA,1,40,54,12,2,108
5673,JetBlue,LAX,PHX,7,32,0,2,4,38
5674,Delta,JFK,SEA,23,40,1,1,22,64
5675,Southwest,LAX,MIA,6,5,28,2,15,50
5676,JetBlue,JFK,SEA,13,0,47,14,18,79
5677,Southwest,ATL,MIA,16,15,34,10,6,65
5678,JetBlue,JFK,BOS,10,32,52,12,8,104
5679,Delta,ATL,BOS,1,1,29,1,2,33
5680,United,LAX,SEA,5,49,22,0,24,95
5681,JetBlue,JFK,MIA,0,10,59,2,6,77
5682,Southwest,ORD,DEN,21,36,6,4,6,52
5683,Delta,DFW,BOS,4,5,10,0,8,23
5684,Southwest,LAX,DEN,13,34,49,10,22,115
5685,JetBlue,ATL,DEN,20,32,43,10,27,112
5686,JetBlue,ORD,MIA,4,3,15,4,2,24
5687,JetBlue,ORD,MIA,3,47,3,13,20,83
5688,United,ATL,PHX,10,51,21,9,26,107
5689,United,DFW,MIA,19,18,29,14,16,77
5690,Delta,ORD,BOS,21,0,12,12,28,52
5691,Southwest,LAX,BOS,1,6,39,6,15,66
5692,JetBlue,LAX,DEN,18,59,22,13,18,112
5693,American,LAX,DEN,3,10,40,13,7,70
5694,United,DFW,MIA,16,11,40,14,0,65
5695,JetBlue,JFK,BOS,14,18,29,11,10,68
5696,Delta,DFW,BOS,20,29,20,2,16,67
5697,Delta,ATL,SEA,9,56,40,11,6,113
5698,American,ORD,SEA,9,13,15,9,19,56
5699,United,JFK,MIA,5,27,28,14,7,76
5700,JetBlue,DFW,DEN,3,16,32,10,14,72
5701,Southwest,DFW,DEN,2,41,50,5,13,109
5702,JetBlue,ATL,PHX,10,37,54,2,1,94
5703,United,LAX,SEA,4,54,5,6,27,92
5704,Delta,ATL,SEA,13,38,8,13,3,62
5705,Southwest,JFK,BOS,11,35,47,9,12,103
5706,United,DFW,PHX,19,30,6,14,1,51
5707,United,ORD,BOS,1,30,37,11,19,97
5708,American,ATL,PHX,16,0,6,1,27,34
5709,American,JFK,DEN,2,36,39,9,28,112
5710,Southwest,ORD,DEN,5,49,13,13,22,97
5711,American,DFW,DEN,18,32,53,8,4,97
5712,Delta,ATL,SEA,11,59,0,13,8,80
5713,American,LAX,MIA,23,0,17,9,3,29
5714,JetBlue,LAX,BOS,23,23,44,8,19,94
5715,United,LAX,BOS,2,30,52,9,0,91
5716,American,ATL,BOS,14,26,35,10,13,84
5717,Delta,JFK,DEN,10,30,12,11,3,56
5718,American,DFW,BOS,13,0,9,1,23,33
5719,American,ORD,SEA,6,57,13,12,7,89
5720,American,DFW,BOS,19,1,21,11,22,55
5721,Southwest,ATL,PHX,9,6,15,14,11,46
5722,Southwest,DFW,MIA,8,1,3,12,12,28
5723,United,LAX,SEA,15,35,27,14,13,89
5724,American,ATL,MIA,1,54,24,0,4,82
5725,Southwest,ORD,BOS,21,5,4,2,14,25
5726,Southwest,DFW,PHX,4,27,34,14,17,92
5727,Southwest,ATL,MIA,4,59,56,3,19,137
5728,American,JFK,SEA,6,18,31,1,11,61
5729,American,DFW,SEA,8,34,3,9,20,66
5730,Delta,DFW,BOS,11,14,9,0,13,36
5731,American,LAX,PHX,9,38,32,9,20,99
5732,United,ORD,SEA,7,31,43,0,5,79
5733,United,ORD,DEN,2,47,4,1,7,59
5734,JetBlue,ATL,BOS,18,51,42,4,10,107
5735,United,LAX,DEN,4,14,30,8,14,66
5736,Southwest,LAX,PHX,9,36,46,9,11,102
5737,United,ORD,SEA,12,52,22,2,13,89
5738,JetBlue,JFK,MIA,9,58,10,4,14,86
5739,American,JFK,MIA,1,44,6,10,4,64
5740,JetBlue,ORD,MIA,23,57,35,11,12,115
5741,Southwest,ORD,DEN,2,42,54,6,4,106
5742,United,LAX,DEN,1,2,23,11,7,43
5743,United,JFK,DEN,21,17,25,13,29,84
5744,Delta,ORD,MIA,19,41,19,6,27,93
5745,Southwest,JFK,MIA,19,8,18,12,7,45
5746,Delta,ATL,PHX,4,7,59,0,12,78
5747,Delta,LAX,PHX,22,51,16,4,25,96
5748,United,ATL,PHX,9,16,18,9,23,66
5749,Delta,JFK,PHX,3,45,57,7,9,118
5750,JetBlue,LAX,DEN,5,38,3,8,28,77
5751,Delta,JFK,DEN,7,30,25,10,16,81
5752,American,ATL,DEN,23,45,25,2,5,77
5753,United,ORD,BOS,23,27,5,1,26,59
5754,American,ORD,PHX,0,0,13,8,7,28
5755,JetBlue,ATL,BOS,20,58,30,5,29,122
5756,JetBlue,ATL,BOS,13,37,16,0,12,65
5757,JetBlue,DFW,SEA,0,34,48,3,15,100
5758,Delta,DFW,MIA,15,46,29,3,10,88
5759,Delta,ORD,PHX,16,45,15,9,24,93
5760,JetBlue,DFW,BOS,2,27,55,13,28,123
5761,American,DFW,PHX,6,12,46,9,29,96
5762,Southwest,ATL,MIA,19,48,57,14,22,141
5763,American,ORD,BOS,23,29,59,8,21,117
5764,Southwest,DFW,DEN,14,19,0,8,9,36
5765,American,LAX,PHX,14,33,11,0,24,68
5766,United,LAX,PHX,0,49,23,2,19,93
5767,American,ORD,MIA,21,49,56,3,4,112
5768,American,ATL,SEA,12,1,25,0,6,32
5769,United,JFK,PHX,19,54,3,4,4,65
5770,United,ORD,PHX,22,11,25,2,10,48
5771,JetBlue,ATL,DEN,0,31,34,14,5,84
5772,Southwest,LAX,DEN,17,3,3,4,28,38
5773,United,ORD,BOS,17,35,31,11,7,84
5774,American,DFW,PHX,10,48,52,7,16,123
5775,American,JFK,PHX,21,31,42,7,16,96
5776,Delta,ATL,BOS,5,29,38,14,22,103
5777,Southwest,LAX,SEA,10,17,20,2,9,48
5778,United,DFW,SEA,16,31,29,7,22,89
5779,American,DFW,SEA,2,29,34,11,17,91
5780,Delta,JFK,DEN,14,43,27,7,29,106
5781,Delta,JFK,MIA,8,57,47,4,21,129
5782,Delta,ATL,PHX,23,38,49,2,13,102
5783,Southwest,ATL,PHX,19,7,35,1,20,63
5784,JetBlue,DFW,MIA,0,37,22,11,26,96
5785,JetBlue,ATL,PHX,17,0,44,2,16,62
5786,JetBlue,ORD,PHX,0,48,56,4,20,128
5787,Southwest,LAX,DEN,1,44,52,14,28,138
5788,JetBlue,ATL,DEN,19,11,38,0,16,65
5789,JetBlue,ATL,DEN,12,29,44,8,12,93
5790,Southwest,ATL,DEN,18,49,10,13,29,101
5791,American,LAX,PHX,2,24,4,9,15,52
5792,United,DFW,SEA,1,42,24,1,23,90
5793,United,ATL,SEA,1,15,6,13,5,39
5794,Southwest,DFW,PHX,8,25,29,14,25,93
5795,Delta,LAX,DEN,0,7,45,1,20,73
5796,Southwest,ATL,BOS,4,55,50,9,23,137
5797,Southwest,JFK,DEN,23,19,29,6,13,67
5798,American,JFK,BOS,2,52,39,13,14,118
5799,JetBlue,ORD,SEA,23,3,13,1,4,21
5800,Southwest,DFW,PHX,16,32,11,8,26,77
5801,Southwest,ORD,DEN,22,16,39,14,6,75
5802,Southwest,DFW,DEN,1,9,40,0,26,75
5803,Southwest,JFK,SEA,2,34,42,0,24,100
5804,United,DFW,PHX,22,17,53,8,6,84
5805,American,ATL,SEA,2,8,14,9,4,35
5806,United,ATL,PHX,12,16,30,0,11,57
5807,United,JFK,DEN,2,0,29,3,4,36
5808,Southwest,ATL,MIA,2,7,15,12,17,51
5809,JetBlue,LAX,BOS,0,17,43,10,13,83
5810,Delta,DFW,MIA,7,5,17,13,22,57
5811,Delta,ATL,PHX,3,42,40,7,3,92
5812,United,LAX,BOS,21,40,3,3,11,57
5813,JetBlue,ATL,BOS,15,46,47,4,22,119
5814,American,JFK,BOS,10,15,22,5,3,45
5815,American,DFW,PHX,11,47,49,4,18,118
5816,United,LAX,MIA,8,52,17,11,21,101
5817,Delta,LAX,DEN,17,35,4,8,13,60
5818,United,DFW,PHX,3,22,8,7,3,40
5819,United,ATL,MIA,7,55,41,5,18,119
5820,Delta,ATL,MIA,13,10,57,6,0,73
5821,United,ORD,SEA,4,36,22,11,0,69
5822,Delta,DFW,MIA,5,15,26,6,2,49
5823,JetBlue,LAX,PHX,20,26,44,6,29,105
5824,American,ATL,PHX,7,51,24,0,13,88
5825,Southwest,ATL,MIA,17,20,4,8,17,49
5826,Southwest,JFK,BOS,1,21,57,12,18,108
5827,Southwest,LAX,SEA,5,5,57,1,17,80
5828,JetBlue,DFW,SEA,1,28,8,7,7,50
5829,United,LAX,PHX,11,54,2,10,10,76
5830,Southwest,ATL,SEA,15,22,38,2,3,65
5831,Delta,ORD,BOS,16,47,25,4,28,104
5832,American,ATL,PHX,7,44,16,10,17,87
5833,American,ORD,SEA,12,18,19,1,4,42
5834,United,JFK,BOS,9,21,34,12,17,84
5835,Delta,ATL,PHX,4,40,17,5,29,91
5836,Delta,ORD,MIA,4,33,49,2,27,111
5837,American,DFW,PHX,8,32,14,4,29,79
5838,United,JFK,MIA,13,18,31,8,17,74
5839,Delta,ORD,DEN,2,36,59,11,16,122
5840,American,JFK,SEA,23,50,10,3,2,65
5841,American,LAX,SEA,11,20,23,14,23,80
5842,Delta,ORD,SEA,8,6,32,6,14,58
5843,JetBlue,ATL,DEN,1,43,25,4,15,87
5844,Delta,JFK,PHX,6,43,9,10,3,65
5845,JetBlue,JFK,MIA,5,19,12,0,19,50
5846,Delta,JFK,BOS,18,6,4,13,26,49
5847,Southwest,JFK,PHX,6,37,55,4,20,116
5848,Southwest,ATL,MIA,9,5,47,3,15,70
5849,Delta,ATL,BOS,0,11,54,1,26,92
5850,American,ATL,PHX,12,25,16,2,0,43
5851,Southwest,JFK,DEN,0,0,38,2,27,67
5852,United,ATL,PHX,5,14,38,9,12,73
5853,Southwest,ATL,SEA,6,4,55,3,14,76
5854,American,LAX,BOS,16,13,8,5,15,41
5855,Delta,ORD,BOS,10,28,11,8,21,68
5856,United,DFW,DEN,22,44,39,4,28,115
5857,American,JFK,BOS,11,19,38,4,15,76
5858,Southwest,JFK,MIA,11,50,30,8,22,110
5859,United,LAX,SEA,15,56,1,13,21,91
5860,United,ORD,MIA,3,33,12,7,29,81
5861,Southwest,JFK,SEA,10,54,33,7,7,101
5862,Delta,LAX,DEN,1,51,40,4,2,97
5863,Delta,JFK,PHX,21,7,38,11,17,73
5864,American,DFW,BOS,18,44,14,0,7,65
5865,United,JFK,BOS,22,10,6,13,13,42
5866,United,LAX,PHX,13,9,28,13,26,76
5867,United,JFK,SEA,3,55,26,0,17,98
5868,Southwest,ORD,DEN,12,30,44,6,17,97
5869,Delta,LAX,SEA,12,6,23,12,21,62
5870,JetBlue,LAX,BOS,17,21,13,0,0,34
5871,American,LAX,PHX,21,28,33,1,16,78
5872,United,DFW,MIA,4,33,52,11,22,118
5873,JetBlue,DFW,MIA,4,0,53,2,6,61
5874,JetBlue,DFW,SEA,11,27,27,6,8,68
5875,United,ORD,PHX,2,11,55,4,2,72
5876,Delta,ATL,PHX,1,18,35,6,26,85
5877,JetBlue,ATL,BOS,13,36,8,13,10,67
5878,Southwest,ORD,DEN,9,5,51,6,10,72
5879,JetBlue,ORD,BOS,12,21,31,5,12,69
5880,JetBlue,DFW,PHX,0,14,6,3,24,47
5881,Delta,ATL,MIA,6,14,0,9,28,51
5882,JetBlue,LAX,DEN,3,42,18,14,24,98
5883,JetBlue,LAX,PHX,10,10,35,6,8,59
5884,Delta,JFK,MIA,4,48,11,3,26,88
5885,Southwest,LAX,MIA,2,56,32,8,29,125
5886,Delta,LAX,SEA,19,19,12,7,16,54
5887,Southwest,DFW,DEN,15,29,59,8,9,105
5888,Delta,LAX,BOS,21,16,12,7,11,46
5889,JetBlue,ATL,DEN,13,59,35,11,24,129
5890,Southwest,LAX,SEA,5,13,31,5,29,78
5891,United,LAX,MIA,4,19,57,11,19,106
5892,American,LAX,DEN,20,37,3,7,4,51
5893,Delta,ORD,MIA,21,57,25,0,4,86
5894,United,ATL,PHX,11,46,51,8,10,115
5895,JetBlue,ATL,MIA,15,55,45,14,28,142
5896,Southwest,ORD,MIA,21,41,24,14,21,100
5897,Delta,LAX,SEA,19,12,18,6,15,51
5898,Southwest,ORD,SEA,21,25,52,4,8,89
5899,Delta,DFW,MIA,7,42,42,4,0,88
5900,American,LAX,PHX,20,18,45,10,29,102
5901,American,ORD,MIA,5,7,4,0,19,30
5902,American,ATL,MIA,22,16,5,13,27,61
5903,Southwest,LAX,MIA,15,0,45,6,29,80
5904,American,JFK,PHX,21,6,59,12,29,106
5905,JetBlue,ATL,PHX,16,58,41,9,29,137
5906,United,JFK,MIA,21,2,0,11,29,42
5907,United,JFK,DEN,12,37,57,4,21,119
5908,United,LAX,BOS,23,22,24,1,4,51
5909,United,JFK,SEA,23,21,40,12,15,88
5910,United,JFK,SEA,19,16,28,5,0,49
5911,United,JFK,MIA,23,31,26,8,1,66
5912,Delta,LAX,BOS,18,25,14,11,27,77
5913,American,LAX,PHX,7,23,24,3,5,55
5914,Delta,DFW,BOS,23,1,43,14,10,68
5915,United,DFW,MIA,3,19,53,12,16,100
5916,Southwest,LAX,MIA,4,24,5,12,17,58
5917,United,ORD,MIA,19,50,45,3,8,106
5918,American,DFW,DEN,3,58,18,6,20,102
5919,United,ORD,MIA,2,39,29,11,8,87
5920,American,JFK,DEN,6,12,53,11,11,87
5921,Delta,ORD,PHX,16,28,19,3,10,60
5922,American,LAX,DEN,22,7,33,8,3,51
5923,American,DFW,SEA,14,44,49,0,8,101
5924,Delta,JFK,MIA,3,16,41,14,27,98
5925,JetBlue,JFK,MIA,2,38,11,9,7,65
5926,United,ORD,PHX,23,29,7,11,19,66
5927,Southwest,ORD,DEN,14,25,43,1,15,84
5928,Southwest,ORD,BOS,19,9,55,11,5,80
5929,United,JFK,DEN,16,57,57,8,2,124
5930,JetBlue,ATL,SEA,15,22,1,6,3,32
5931,Delta,LAX,BOS,22,5,22,4,3,34
5932,Delta,LAX,SEA,7,34,16,1,2,53
5933,JetBlue,JFK,DEN,6,50,54,9,5,118
5934,United,DFW,BOS,2,24,56,13,18,111
5935,Delta,LAX,BOS,19,55,12,9,0,76
5936,Delta,ORD,MIA,17,38,6,6,20,70
5937,Southwest,LAX,BOS,2,40,32,10,5,87
5938,JetBlue,ATL,DEN,6,19,59,12,23,113
5939,Delta,DFW,DEN,11,57,26,13,11,107
5940,United,ATL,BOS,20,34,23,1,0,58
5941,JetBlue,ATL,SEA,12,3,53,9,28,93
5942,JetBlue,JFK,PHX,9,13,59,7,11,90
5943,United,ORD,SEA,5,31,23,5,0,59
5944,Southwest,JFK,MIA,5,19,15,0,19,53
5945,Delta,ATL,MIA,16,12,38,4,4,58
5946,American,DFW,MIA,5,6,27,5,22,60
5947,JetBlue,JFK,MIA,14,8,23,2,16,49
5948,JetBlue,ORD,PHX,0,30,0,13,7,50
5949,United,ORD,PHX,22,50,57,4,19,130
5950,Southwest,ATL,BOS,16,26,4,7,24,61
5951,Southwest,DFW,SEA,3,20,55,2,15,92
5952,American,DFW,BOS,10,33,8,11,10,62
5953,JetBlue,DFW,MIA,10,47,20,1,6,74
5954,American,ATL,PHX,20,50,2,13,25,90
5955,American,ATL,MIA,20,31,21,1,0,53
5956,American,LAX,MIA,18,14,6,2,1,23
5957,Southwest,JFK,DEN,22,10,20,3,2,35
5958,Delta,ORD,BOS,7,41,41,14,16,112
5959,Southwest,LAX,SEA,10,24,7,13,8,52
5960,Southwest,JFK,MIA,16,47,18,9,16,90
5961,United,DFW,SEA,18,2,45,4,27,78
5962,United,DFW,PHX,16,54,31,9,17,111
5963,American,JFK,MIA,21,30,55,8,5,98
5964,Delta,LAX,DEN,9,29,14,2,12,57
5965,United,DFW,BOS,23,53,11,2,17,83
5966,American,ATL,DEN,0,45,57,13,5,120
5967,Delta,JFK,PHX,4,16,46,13,17,92
5968,Southwest,LAX,BOS,10,34,17,13,23,87
5969,United,LAX,MIA,15,18,59,6,22,105
5970,Southwest,JFK,DEN,18,42,14,11,10,77
5971,Delta,LAX,SEA,8,4,12,9,10,35
5972,JetBlue,JFK,DEN,18,28,46,11,4,89
5973,Delta,LAX,SEA,22,0,18,1,5,24
5974,United,LAX,BOS,4,8,4,6,13,31
5975,Delta,ATL,SEA,16,5,55,4,9,73
5976,American,JFK,BOS,20,1,16,3,22,42
5977,JetBlue,ORD,MIA,16,25,39,1,4,69
5978,JetBlue,ATL,MIA,18,48,11,0,26,85
5979,American,DFW,MIA,21,17,17,7,22,63
5980,American,DFW,PHX,17,0,51,10,1,62
5981,United,ORD,DEN,6,37,57,2,19,115
5982,Southwest,ORD,MIA,4,40,9,8,26,83
5983,Delta,JFK,BOS,17,2,36,4,19,61
5984,Delta,DFW,DEN,18,28,2,3,5,38
5985,Southwest,ATL,PHX,17,39,45,2,28,114
5986,Southwest,DFW,SEA,12,39,42,11,24,116
5987,Delta,ORD,PHX,10,24,18,4,17,63
5988,JetBlue,ATL,MIA,5,6,48,5,5,64
5989,JetBlue,ATL,SEA,21,26,42,2,7,77
5990,Southwest,ORD,SEA,10,14,14,8,23,59
5991,United,LAX,BOS,16,40,14,7,11,72
5992,Southwest,DFW,PHX,16,30,25,8,6,69
5993,Delta,LAX,SEA,19,49,59,11,11,130
5994,American,DFW,DEN,15,38,27,9,7,81
5995,United,LAX,PHX,23,51,20,9,13,93
5996,American,ATL,DEN,23,10,20,2,24,56
5997,American,ORD,PHX,16,7,23,1,4,35
5998,United,DFW,MIA,13,29,57,4,15,105
5999,United,ATL,DEN,5,52,7,5,8,72
6000,American,ATL,BOS,9,25,31,12,16,84
6001,American,JFK,SEA,15,54,11,8,26,99
6002,American,JFK,MIA,17,50,11,13,6,80
6003,United,DFW,BOS,23,49,2,0,25,76
6004,Delta,ORD,PHX,18,54,32,7,13,106
6005,United,LAX,DEN,15,2,49,4,1,56
6006,Southwest,JFK,MIA,7,20,57,5,8,90
6007,Southwest,LAX,SEA,2,3,34,11,5,53
6008,United,LAX,BOS,11,51,15,13,6,85
6009,Delta,ATL,DEN,16,35,18,2,23,78
6010,Delta,ORD,BOS,23,18,25,0,21,64
6011,Southwest,JFK,DEN,21,52,16,4,26,98
6012,Southwest,ATL,MIA,8,7,8,4,20,39
6013,Delta,LAX,MIA,7,9,10,13,14,46
6014,United,LAX,BOS,23,58,22,6,19,105
6015,Southwest,LAX,PHX,7,34,36,4,19,93
6016,United,JFK,PHX,22,9,16,13,21,59
6017,United,DFW,BOS,0,59,46,7,27,139
6018,JetBlue,DFW,MIA,0,29,2,2,20,53
6019,Delta,JFK,SEA,16,50,27,14,3,94
6020,United,JFK,SEA,14,55,43,7,3,108
6021,Southwest,JFK,BOS,10,38,28,6,1,73
6022,JetBlue,ATL,MIA,10,14,10,6,12,42
6023,JetBlue,JFK,MIA,4,37,29,8,6,80
6024,Delta,JFK,MIA,1,18,12,9,23,62
6025,United,LAX,SEA,15,36,33,13,13,95
6026,Delta,ATL,BOS,1,40,27,14,0,81
6027,JetBlue,LAX,MIA,0,27,13,14,13,67
6028,JetBlue,JFK,MIA,4,58,50,0,22,130
6029,JetBlue,JFK,BOS,19,49,52,0,18,119
6030,American,ATL,BOS,23,0,1,4,10,15
6031,American,LAX,MIA,19,33,30,8,20,91
6032,United,ATL,SEA,3,41,34,1,21,97
6033,Delta,LAX,DEN,13,43,56,6,1,106
6034,Southwest,JFK,BOS,11,58,30,3,19,110
6035,JetBlue,DFW,SEA,17,6,47,6,20,79
6036,JetBlue,LAX,PHX,19,22,27,11,28,88
6037,United,ORD,PHX,3,29,28,1,15,73
6038,JetBlue,JFK,DEN,2,58,21,2,25,106
6039,JetBlue,JFK,PHX,17,50,58,0,7,115
6040,American,ATL,MIA,21,52,48,7,21,128
6041,United,DFW,DEN,23,46,31,8,2,87
6042,JetBlue,DFW,PHX,7,54,2,12,14,82
6043,Delta,JFK,DEN,12,51,46,14,7,118
6044,United,DFW,BOS,4,52,44,14,18,128
6045,JetBlue,DFW,DEN,12,18,49,13,22,102
6046,American,LAX,PHX,14,47,21,9,25,102
6047,Delta,DFW,BOS,0,29,54,1,8,92
6048,JetBlue,ATL,MIA,1,47,54,2,11,114
6049,Delta,DFW,BOS,5,0,38,0,9,47
6050,Southwest,LAX,DEN,6,1,54,1,4,60
6051,United,ORD,MIA,2,11,57,9,16,93
6052,Southwest,ORD,PHX,20,24,23,4,8,59
6053,American,LAX,BOS,4,48,7,10,24,89
6054,American,LAX,SEA,19,11,35,11,17,74
6055,Southwest,ATL,PHX,21,57,11,7,19,94
6056,Southwest,JFK,DEN,19,11,29,0,5,45
6057,JetBlue,ORD,SEA,18,45,5,13,20,83
6058,Southwest,JFK,BOS,16,15,55,12,27,109
6059,Southwest,ORD,PHX,10,23,44,7,9,83
6060,Southwest,DFW,MIA,0,30,6,13,8,57
6061,United,JFK,SEA,6,4,6,10,1,21
6062,United,ORD,PHX,8,29,43,7,3,82
6063,Delta,LAX,BOS,22,36,59,0,21,116
6064,United,DFW,SEA,14,8,19,13,1,41
6065,Southwest,DFW,MIA,11,58,56,13,2,129
6066,Delta,LAX,BOS,19,13,36,6,19,74
6067,Southwest,ORD,BOS,23,31,28,5,2,66
6068,Southwest,DFW,DEN,4,49,52,7,10,118
6069,United,DFW,PHX,10,7,48,7,12,74
6070,Delta,LAX,SEA,5,55,10,3,26,94
6071,Delta,DFW,PHX,9,25,33,3,23,84
6072,United,LAX,DEN,18,19,52,12,29,112
6073,United,ORD,DEN,20,9,14,4,18,45
6074,American,ORD,SEA,1,26,33,9,2,70
6075,JetBlue,DFW,PHX,5,4,33,5,19,61
6076,American,ORD,SEA,7,32,23,12,5,72
6077,American,DFW,MIA,18,27,31,14,26,98
6078,American,DFW,BOS,7,6,12,9,24,51
6079,Delta,ATL,DEN,17,44,55,9,7,115
6080,Southwest,DFW,SEA,10,16,0,11,23,50
6081,American,ATL,BOS,2,32,27,8,4,71
6082,JetBlue,DFW,DEN,21,9,51,3,25,88
6083,American,LAX,SEA,19,8,42,2,2,54
6084,United,ORD,SEA,3,56,35,12,17,120
6085,Southwest,JFK,PHX,16,42,32,6,8,88
6086,JetBlue,ORD,DEN,16,18,54,3,27,102
6087,JetBlue,LAX,DEN,22,21,59,12,16,108
6088,JetBlue,LAX,BOS,13,59,39,8,11,117
6089,American,ATL,PHX,5,0,8,2,0,10
6090,JetBlue,ATL,PHX,17,54,8,9,5,76
6091,American,ATL,SEA,16,4,6,1,0,11
6092,Delta,DFW,MIA,10,21,23,3,27,74
6093,Southwest,LAX,PHX,19,32,27,5,0,64
6094,JetBlue,JFK,MIA,17,36,1,8,0,45
6095,United,LAX,BOS,8,24,28,5,10,67
6096,Delta,ORD,DEN,16,13,51,3,17,84
6097,United,DFW,BOS,15,33,55,1,23,112
6098,United,LAX,SEA,1,59,30,2,3,94
6099,Southwest,ATL,SEA,7,44,21,14,22,101
6100,Southwest,ATL,MIA,19,2,28,6,13,49
6101,American,LAX,BOS,10,46,1,1,1,49
6102,United,JFK,DEN,18,16,21,8,9,54
6103,JetBlue,ATL,PHX,18,24,47,3,20,94
6104,Delta,ORD,PHX,1,33,38,12,22,105
6105,JetBlue,ORD,MIA,9,7,59,4,14,84
6106,Southwest,DFW,SEA,14,13,11,12,19,55
6107,Southwest,ORD,DEN,16,29,31,4,27,91
6108,JetBlue,ORD,MIA,5,49,26,7,20,102
6109,Southwest,ATL,PHX,18,9,30,8,25,72
6110,Delta,DFW,SEA,18,22,42,8,29,101
6111,Southwest,LAX,PHX,17,55,38,12,21,126
6112,Delta,ORD,MIA,6,50,57,6,6,119
6113,American,ORD,SEA,22,26,42,10,22,100
6114,Delta,DFW,DEN,13,42,58,13,25,138
6115,Southwest,ATL,MIA,18,25,33,5,28,91
6116,Southwest,ORD,DEN,13,58,14,10,8,90
6117,American,LAX,SEA,17,58,2,4,7,71
6118,JetBlue,ATL,PHX,19,58,58,7,5,128
6119,United,DFW,DEN,7,9,27,1,28,65
6120,United,JFK,PHX,12,56,54,7,1,118
6121,American,DFW,DEN,11,26,42,14,6,88
6122,Southwest,JFK,MIA,10,13,5,1,0,19
6123,Delta,ORD,DEN,23,41,26,9,21,97
6124,United,DFW,MIA,15,1,53,10,4,68
6125,American,JFK,DEN,6,5,19,13,4,41
6126,Delta,ORD,MIA,19,16,13,2,25,56
6127,American,DFW,BOS,11,10,45,12,19,86
6128,JetBlue,DFW,SEA,19,44,31,3,3,81
6129,JetBlue,LAX,SEA,7,44,37,0,21,102
6130,Southwest,DFW,PHX,4,39,53,11,19,122
6131,Southwest,LAX,PHX,15,29,2,1,23,55
6132,American,ORD,PHX,8,27,36,14,16,93
6133,United,ORD,BOS,21,22,8,0,10,40
6134,JetBlue,LAX,DEN,1,24,13,2,2,41
6135,Southwest,JFK,SEA,15,28,16,11,29,84
6136,American,JFK,BOS,11,59,51,0,25,135
6137,Southwest,ATL,PHX,13,2,31,11,28,72
6138,Delta,ORD,MIA,4,45,28,10,20,103
6139,United,JFK,PHX,17,29,27,1,4,61
6140,American,LAX,PHX,4,31,3,10,7,51
6141,JetBlue,JFK,BOS,23,59,3,5,1,68
6142,Southwest,LAX,BOS,14,14,3,3,8,28
6143,JetBlue,ATL,BOS,23,10,0,10,28,48
6144,United,ATL,PHX,10,3,2,10,17,32
6145,JetBlue,DFW,DEN,20,24,25,8,12,69
6146,American,ORD,SEA,22,4,34,0,12,50
6147,United,LAX,MIA,3,48,14,3,15,80
6148,United,ORD,DEN,3,56,28,14,21,119
6149,United,ATL,DEN,10,18,21,4,16,59
6150,Delta,ATL,DEN,16,57,1,13,8,79
6151,American,LAX,DEN,16,36,0,6,6,48
6152,Delta,ATL,PHX,23,1,43,7,0,51
6153,United,JFK,SEA,8,45,19,14,18,96
6154,American,DFW,MIA,13,10,15,11,3,39
6155,JetBlue,ATL,PHX,10,6,10,14,14,44
6156,Southwest,DFW,DEN,18,4,31,11,23,69
6157,JetBlue,ORD,MIA,3,33,28,8,7,76
6158,Southwest,LAX,BOS,7,5,0,3,24,32
6159,United,JFK,DEN,11,19,18,14,26,77
6160,Delta,JFK,MIA,23,28,14,14,28,84
6161,American,ATL,SEA,13,38,11,10,25,84
6162,JetBlue,ATL,BOS,13,39,1,9,21,70
6163,JetBlue,JFK,BOS,23,4,4,1,17,26
6164,American,JFK,SEA,6,11,45,2,24,82
6165,United,DFW,PHX,15,20,55,8,19,102
6166,United,ORD,BOS,13,31,25,3,20,79
6167,United,ATL,DEN,23,17,46,13,14,90
6168,United,JFK,SEA,8,52,42,3,14,111
6169,Southwest,DFW,PHX,16,30,30,6,12,78
6170,Southwest,DFW,DEN,7,56,11,5,17,89
6171,American,ORD,BOS,13,33,42,0,13,88
6172,JetBlue,DFW,SEA,5,14,33,3,11,61
6173,Southwest,ATL,DEN,19,12,9,5,1,27
6174,JetBlue,ORD,BOS,7,40,10,5,9,64
6175,American,LAX,MIA,5,46,29,9,23,107
6176,Southwest,ORD,DEN,10,1,54,6,19,80
6177,United,LAX,SEA,2,8,5,0,17,30
6178,JetBlue,JFK,PHX,0,49,9,0,2,60
6179,JetBlue,JFK,DEN,10,38,23,11,0,72
6180,Southwest,LAX,MIA,8,56,53,13,4,126
6181,Southwest,LAX,DEN,1,4,2,1,28,35
6182,JetBlue,ORD,SEA,14,39,39,10,19,107
6183,Southwest,ORD,DEN,6,58,30,3,20,111
6184,American,JFK,PHX,12,52,32,2,14,100
6185,JetBlue,ATL,DEN,17,33,27,0,22,82
6186,JetBlue,DFW,BOS,22,35,31,7,2,75
6187,American,LAX,SEA,9,19,21,3,5,48
6188,Delta,ORD,DEN,22,10,3,9,9,31
6189,American,LAX,MIA,7,18,18,4,1,41
6190,JetBlue,DFW,MIA,17,20,30,5,11,66
6191,Delta,JFK,DEN,6,33,17,2,6,58
6192,United,DFW,DEN,19,24,54,2,25,105
6193,Southwest,ATL,PHX,10,37,41,9,13,100
6194,Delta,LAX,SEA,18,30,9,9,28,76
6195,Delta,ORD,DEN,1,41,32,10,24,107
6196,Southwest,ATL,SEA,10,42,33,0,18,93
6197,United,ORD,DEN,10,17,16,12,20,65
6198,United,ORD,MIA,11,45,8,6,29,88
6199,Delta,DFW,DEN,7,34,59,11,23,127
6200,Delta,ATL,MIA,23,14,53,6,7,80
6201,Southwest,ORD,PHX,4,6,1,11,17,35
6202,JetBlue,ATL,SEA,10,46,30,1,1,78
6203,Delta,DFW,SEA,18,42,37,6,22,107
6204,United,ORD,SEA,15,40,59,11,9,119
6205,American,LAX,MIA,5,44,24,11,3,82
6206,Delta,ORD,MIA,20,43,38,10,11,102
6207,American,JFK,DEN,7,20,45,9,11,85
6208,Southwest,LAX,SEA,8,47,56,8,11,122
6209,JetBlue,JFK,SEA,10,51,42,14,10,117
6210,Delta,JFK,PHX,5,52,24,12,10,98
6211,American,ATL,SEA,13,4,33,11,3,51
6212,JetBlue,LAX,MIA,7,12,43,13,4,72
6213,American,ORD,PHX,15,44,39,3,20,106
6214,American,ORD,PHX,23,30,35,1,11,77
6215,United,JFK,MIA,23,2,37,4,6,49
6216,American,LAX,PHX,9,36,38,4,22,100
6217,Delta,ATL,PHX,7,36,24,3,23,86
6218,Southwest,ATL,BOS,18,37,18,5,2,62
6219,United,ATL,DEN,17,11,59,6,1,77
6220,Southwest,DFW,PHX,4,59,48,14,29,150
6221,Delta,ORD,MIA,22,19,59,2,6,86
6222,Delta,ORD,MIA,10,36,17,11,21,85
6223,Delta,JFK,MIA,10,51,47,4,28,130
6224,Delta,ATL,DEN,22,17,27,3,25,72
6225,United,ATL,SEA,2,33,29,6,10,78
6226,American,ATL,DEN,21,28,58,13,2,101
6227,Delta,DFW,SEA,8,18,49,4,26,97
6228,United,ATL,SEA,1,51,47,4,19,121
6229,Southwest,LAX,DEN,10,58,17,13,25,113
6230,United,LAX,PHX,11,26,55,3,28,112
6231,JetBlue,DFW,PHX,20,53,20,6,1,80
6232,American,ORD,DEN,8,27,50,14,15,106
6233,American,ATL,MIA,18,13,44,9,16,82
6234,Delta,JFK,SEA,15,57,25,0,1,83
6235,Delta,ORD,SEA,1,44,3,5,18,70
6236,Southwest,LAX,PHX,2,26,8,5,13,52
6237,JetBlue,DFW,DEN,14,18,35,6,7,66
6238,JetBlue,DFW,SEA,10,52,1,10,13,76
6239,Delta,ATL,MIA,17,20,27,3,0,50
6240,Southwest,ORD,SEA,7,42,58,7,0,107
6241,JetBlue,ORD,PHX,11,48,40,8,27,123
6242,Delta,ORD,PHX,1,58,16,8,18,100
6243,Southwest,LAX,MIA,7,18,10,6,13,47
6244,American,ORD,BOS,4,28,45,13,29,115
6245,Southwest,DFW,SEA,9,1,55,3,25,84
6246,Southwest,LAX,PHX,17,17,45,7,20,89
6247,American,JFK,DEN,5,39,58,0,25,122
6248,JetBlue,LAX,BOS,22,22,51,5,5,83
6249,United,JFK,BOS,15,14,0,14,12,40
6250,Delta,ATL,PHX,5,7,19,3,29,58
6251,Southwest,ORD,MIA,0,25,32,1,23,81
6252,JetBlue,JFK,MIA,10,19,31,7,29,86
6253,Southwest,DFW,DEN,19,32,10,12,5,59
6254,JetBlue,LAX,SEA,0,25,5,0,16,46
6255,American,ATL,SEA,11,46,48,5,15,114
6256,United,ATL,DEN,18,4,57,8,5,74
6257,United,JFK,SEA,14,26,52,6,1,85
6258,Delta,ORD,BOS,0,16,36,8,9,69
6259,JetBlue,JFK,MIA,8,20,4,6,3,33
6260,Delta,DFW,DEN,18,2,41,13,14,70
6261,Southwest,DFW,BOS,23,59,38,14,4,115
6262,JetBlue,JFK,DEN,11,2,51,7,5,65
6263,United,ORD,MIA,1,30,12,14,16,72
6264,American,LAX,SEA,19,29,0,6,8,43
6265,JetBlue,ATL,SEA,17,9,19,1,17,46
6266,United,ORD,PHX,0,35,52,0,6,93
6267,American,ORD,MIA,17,29,27,7,13,76
6268,Delta,JFK,PHX,0,23,39,3,13,78
6269,United,ATL,PHX,12,23,18,10,7,58
6270,JetBlue,ATL,BOS,12,53,59,12,10,134
6271,United,JFK,SEA,16,7,44,4,19,74
6272,American,ATL,DEN,10,50,34,4,18,106
6273,Southwest,JFK,MIA,6,55,57,10,22,144
6274,American,ORD,SEA,16,21,23,13,9,66
6275,United,ORD,BOS,16,18,7,6,21,52
6276,JetBlue,LAX,MIA,23,48,6,3,1,58
6277,JetBlue,ORD,MIA,22,13,3,0,18,34
6278,JetBlue,DFW,DEN,1,12,30,7,29,78
6279,United,DFW,DEN,19,15,10,6,8,39
6280,American,ORD,BOS,8,26,41,5,9,81
6281,United,ATL,MIA,21,43,47,1,24,115
6282,United,ATL,PHX,2,53,3,5,5,66
6283,United,ORD,SEA,3,49,22,5,12,88
6284,American,LAX,MIA,12,33,18,10,20,81
6285,American,JFK,SEA,6,10,22,0,25,57
6286,Delta,LAX,SEA,15,31,29,1,6,67
6287,Southwest,DFW,BOS,15,31,35,7,17,90
6288,JetBlue,DFW,BOS,6,54,15,2,19,90
6289,Delta,ATL,SEA,14,59,33,6,1,99
6290,United,ATL,DEN,6,0,2,3,4,9
6291,United,ATL,PHX,2,24,13,7,0,44
6292,United,DFW,MIA,18,48,50,8,20,126
6293,Southwest,JFK,BOS,9,24,40,6,4,74
6294,United,LAX,MIA,19,33,7,1,10,51
6295,Delta,ORD,SEA,5,9,53,6,11,79
6296,Southwest,LAX,SEA,13,21,38,2,5,66
6297,JetBlue,DFW,MIA,7,24,46,9,14,93
6298,JetBlue,DFW,BOS,0,20,48,6,13,87
6299,Delta,DFW,BOS,1,37,44,2,20,103
6300,JetBlue,JFK,BOS,18,5,55,12,4,76
6301,United,ORD,DEN,14,46,2,2,27,77
6302,United,JFK,SEA,23,38,4,8,15,65
6303,United,ATL,DEN,5,37,9,7,5,58
6304,Southwest,JFK,BOS,10,1,1,14,9,25
6305,JetBlue,LAX,PHX,16,6,11,14,14,45
6306,Delta,ORD,SEA,7,45,45,14,15,119
6307,United,DFW,PHX,17,2,36,6,9,53
6308,JetBlue,DFW,DEN,10,53,28,3,12,96
6309,Southwest,JFK,PHX,19,21,33,6,9,69
6310,Southwest,ORD,BOS,7,34,47,7,17,105
6311,JetBlue,LAX,BOS,20,25,35,8,28,96
6312,American,ORD,BOS,1,50,38,14,28,130
6313,JetBlue,DFW,DEN,10,24,35,10,12,81
6314,American,ORD,BOS,14,33,29,11,17,90
6315,United,DFW,MIA,21,22,11,13,0,46
6316,American,ATL,MIA,17,19,6,0,13,38
6317,Delta,ATL,BOS,17,16,45,6,6,73
6318,American,JFK,PHX,16,27,46,6,8,87
6319,United,ORD,DEN,11,16,4,1,23,44
6320,Delta,JFK,BOS,17,49,34,1,12,96
6321,Delta,ATL,PHX,12,7,30,3,4,44
6322,American,DFW,PHX,16,34,28,1,23,86
6323,JetBlue,ATL,SEA,5,46,39,8,24,117
6324,American,LAX,PHX,5,49,17,3,4,73
6325,American,ATL,PHX,20,27,5,8,21,61
6326,JetBlue,ATL,DEN,19,22,24,1,20,67
6327,JetBlue,ORD,BOS,11,39,49,1,29,118
6328,Delta,ATL,SEA,6,39,27,2,20,88
6329,JetBlue,ATL,SEA,11,45,35,11,4,95
6330,JetBlue,LAX,DEN,12,50,40,11,0,101
6331,American,LAX,MIA,13,47,49,12,28,136
6332,United,ATL,BOS,4,0,9,5,23,37
6333,JetBlue,JFK,DEN,1,59,27,3,13,102
6334,United,ORD,BOS,7,41,25,0,6,72
6335,JetBlue,ATL,BOS,22,59,6,3,10,78
6336,American,ATL,SEA,19,31,59,14,15,119
6337,JetBlue,JFK,BOS,7,20,5,14,14,53
6338,American,JFK,PHX,8,30,22,3,14,69
6339,Delta,LAX,MIA,10,31,33,12,11,87
6340,Southwest,ATL,BOS,20,36,40,9,13,98
6341,Southwest,JFK,BOS,2,44,0,5,2,51
6342,JetBlue,LAX,PHX,15,31,8,8,22,69
6343,American,LAX,PHX,23,34,17,3,28,82
6344,Southwest,DFW,MIA,13,35,16,2,10,63
6345,United,DFW,MIA,2,43,22,6,17,88
6346,American,LAX,BOS,5,55,16,9,2,82
6347,Delta,DFW,SEA,1,46,49,6,5,106
6348,Southwest,ATL,MIA,15,13,39,5,24,81
6349,American,DFW,BOS,18,13,13,6,16,48
6350,American,DFW,BOS,6,44,10,0,5,59
6351,Delta,DFW,PHX,8,37,30,0,27,94
6352,JetBlue,ORD,SEA,19,19,9,0,27,55
6353,Southwest,JFK,BOS,10,40,36,2,10,88
6354,American,LAX,PHX,23,48,52,0,5,105
6355,Southwest,ORD,SEA,15,23,21,3,11,58
6356,American,ORD,SEA,1,6,45,7,26,84
6357,Delta,LAX,SEA,18,54,48,9,1,112
6358,American,ATL,BOS,1,3,26,14,23,66
6359,Southwest,DFW,SEA,21,53,5,1,11,70
6360,Southwest,ORD,SEA,6,58,58,2,1,119
6361,Southwest,LAX,MIA,13,47,15,8,20,90
6362,Southwest,LAX,MIA,21,22,11,7,28,68
6363,United,ORD,PHX,21,59,38,6,8,111
6364,Delta,LAX,SEA,13,25,57,12,21,115
6365,Delta,ORD,BOS,14,12,50,11,26,99
6366,United,DFW,PHX,13,16,34,0,16,66
6367,United,ORD,MIA,22,19,41,7,7,74
6368,American,LAX,MIA,4,13,34,3,21,71
6369,United,LAX,PHX,20,2,31,6,22,61
6370,Southwest,ORD,PHX,6,51,10,10,7,78
6371,JetBlue,ATL,SEA,7,12,34,13,18,77
6372,JetBlue,ATL,DEN,5,10,55,6,9,80
6373,Delta,JFK,MIA,17,44,32,3,17,96
6374,American,ORD,SEA,14,48,37,5,28,118
6375,United,LAX,BOS,16,51,9,6,28,94
6376,American,ATL,DEN,23,47,22,0,3,72
6377,JetBlue,DFW,SEA,23,16,15,1,13,45
6378,United,ATL,BOS,4,13,39,11,13,76
6379,United,DFW,BOS,0,26,0,14,7,47
6380,Southwest,LAX,SEA,8,44,29,11,18,102
6381,Southwest,ATL,BOS,16,24,46,12,8,90
6382,United,JFK,SEA,0,22,0,6,18,46
6383,American,DFW,SEA,23,26,30,12,27,95
6384,United,LAX,PHX,2,7,59,10,1,77
6385,Southwest,ATL,PHX,7,13,37,3,18,71
6386,Southwest,DFW,SEA,18,46,22,8,19,95
6387,Southwest,DFW,BOS,16,6,55,9,29,99
6388,American,JFK,PHX,10,51,43,8,3,105
6389,Delta,LAX,PHX,22,31,34,4,9,78
6390,American,ORD,DEN,4,34,15,0,29,78
6391,American,DFW,DEN,12,45,16,0,9,70
6392,Southwest,DFW,MIA,0,3,29,8,16,56
6393,American,ATL,PHX,21,4,31,11,21,67
6394,JetBlue,ATL,BOS,18,3,5,10,2,20
6395,Southwest,ORD,SEA,15,14,43,4,1,62
6396,United,ATL,PHX,20,50,37,8,8,103
6397,JetBlue,JFK,DEN,10,50,33,6,29,118
6398,United,ATL,SEA,8,47,29,1,18,95
6399,Delta,ORD,MIA,2,39,43,7,17,106
6400,JetBlue,ATL,DEN,2,16,23,2,23,64
6401,American,ORD,DEN,1,19,18,6,12,55
6402,American,JFK,BOS,15,12,51,13,12,88
6403,JetBlue,ORD,DEN,2,23,22,7,13,65
6404,Southwest,DFW,BOS,7,36,33,5,5,79
6405,United,LAX,BOS,20,52,16,9,18,95
6406,Delta,LAX,PHX,13,31,8,9,1,49
6407,JetBlue,DFW,BOS,9,2,59,14,27,102
6408,JetBlue,DFW,SEA,18,18,43,6,21,88
6409,Delta,LAX,SEA,6,5,27,4,3,39
6410,United,JFK,MIA,10,12,43,6,2,63
6411,JetBlue,LAX,DEN,12,34,5,9,18,66
6412,Southwest,JFK,MIA,12,12,40,9,14,75
6413,JetBlue,DFW,BOS,11,45,48,4,20,117
6414,American,JFK,DEN,12,14,56,5,24,99
6415,Southwest,DFW,MIA,11,28,17,1,9,55
6416,American,ORD,DEN,23,38,18,13,27,96
6417,JetBlue,LAX,BOS,8,26,40,2,25,93
6418,American,DFW,MIA,11,53,5,5,2,65
6419,Delta,LAX,PHX,2,42,13,11,2,68
6420,United,ATL,SEA,12,5,41,1,9,56
6421,JetBlue,JFK,PHX,17,14,48,0,22,84
6422,United,ORD,SEA,18,47,10,7,14,78
6423,United,ATL,PHX,18,59,18,5,20,102
6424,Southwest,ORD,DEN,8,0,13,1,18,32
6425,Southwest,JFK,SEA,12,49,13,5,26,93
6426,JetBlue,JFK,PHX,10,5,30,2,14,51
6427,American,DFW,BOS,3,9,54,0,0,63
6428,United,LAX,MIA,5,14,37,14,20,85
6429,American,ATL,BOS,1,9,50,2,27,88
6430,American,ORD,BOS,15,35,55,6,19,115
6431,Southwest,ORD,BOS,3,16,19,3,29,67
6432,United,DFW,SEA,3,23,11,13,22,69
6433,American,JFK,SEA,10,53,40,2,4,99
6434,Delta,JFK,PHX,21,43,35,6,27,111
6435,Southwest,ORD,SEA,12,38,57,13,24,132
6436,American,DFW,SEA,1,48,42,0,29,119
6437,JetBlue,JFK,DEN,7,46,35,3,21,105
6438,United,LAX,DEN,14,13,42,2,28,85
6439,Southwest,ATL,MIA,17,53,54,14,18,139
6440,Delta,LAX,PHX,1,8,34,0,5,47
6441,Delta,LAX,PHX,7,19,11,9,23,62
6442,United,JFK,DEN,20,6,40,10,20,76
6443,Delta,DFW,SEA,12,22,53,10,10,95
6444,United,DFW,SEA,9,12,41,10,26,89
6445,United,ATL,BOS,14,25,49,1,12,87
6446,American,ATL,SEA,20,13,31,0,25,69
6447,American,LAX,MIA,23,33,40,12,15,100
6448,JetBlue,LAX,SEA,21,54,17,10,29,110
6449,United,ORD,PHX,0,51,43,7,15,116
6450,United,ORD,SEA,15,5,24,1,10,40
6451,American,ORD,MIA,17,18,33,6,9,66
6452,JetBlue,DFW,PHX,1,37,52,14,10,113
6453,United,JFK,DEN,8,26,56,0,20,102
6454,Delta,ORD,PHX,20,53,52,9,25,139
6455,American,LAX,DEN,16,42,36,8,10,96
6456,Delta,ORD,SEA,1,7,24,0,22,53
6457,Delta,ORD,BOS,3,18,13,0,26,57
6458,American,LAX,SEA,21,24,46,5,8,83
6459,Delta,JFK,BOS,14,52,5,11,21,89
6460,Southwest,DFW,SEA,1,47,58,13,9,127
6461,JetBlue,DFW,DEN,2,41,1,0,2,44
6462,American,ORD,PHX,12,34,53,6,22,115
6463,American,JFK,MIA,11,40,32,3,16,91
6464,Southwest,ORD,BOS,0,12,58,12,4,86
6465,American,ATL,SEA,7,43,22,12,10,87
6466,Delta,LAX,BOS,15,12,42,1,4,59
6467,Southwest,ATL,BOS,9,9,5,13,22,49
6468,United,LAX,SEA,20,28,56,0,20,104
6469,Delta,DFW,DEN,1,46,23,0,16,85
6470,Southwest,ATL,BOS,6,44,51,11,4,110
6471,JetBlue,LAX,MIA,8,45,46,11,7,109
6472,American,ORD,PHX,14,58,12,7,9,86
6473,United,JFK,BOS,14,24,28,4,24,80
6474,United,JFK,SEA,7,41,9,7,25,82
6475,Delta,JFK,SEA,21,28,59,2,14,103
6476,American,LAX,DEN,12,45,57,14,0,116
6477,Southwest,ORD,SEA,17,49,21,9,6,85
6478,American,ORD,DEN,9,57,19,1,29,106
6479,American,ORD,PHX,21,56,59,6,28,149
6480,JetBlue,ORD,PHX,8,1,9,11,1,22
6481,JetBlue,ORD,BOS,12,31,21,13,28,93
6482,JetBlue,ATL,DEN,18,44,35,1,3,83
6483,American,ORD,DEN,18,5,0,4,15,24
6484,Southwest,LAX,SEA,5,1,6,10,12,29
6485,JetBlue,ATL,DEN,1,29,7,11,4,51
6486,JetBlue,DFW,PHX,4,57,56,6,22,141
6487,Delta,ORD,MIA,22,54,12,7,8,81
6488,American,JFK,DEN,4,23,3,8,6,40
6489,Southwest,DFW,SEA,0,43,45,8,3,99
6490,United,DFW,MIA,14,36,55,14,29,134
6491,American,ORD,PHX,15,49,33,7,18,107
6492,United,DFW,MIA,0,56,54,3,3,116
6493,Southwest,ORD,BOS,22,52,5,1,24,82
6494,Delta,ORD,SEA,20,15,29,9,4,57
6495,Southwest,DFW,BOS,2,34,45,11,4,94
6496,American,JFK,DEN,2,15,51,7,0,73
6497,American,ORD,DEN,12,9,9,7,17,42
6498,JetBlue,JFK,PHX,12,59,3,2,28,92
6499,United,DFW,SEA,21,11,19,6,13,49
6500,JetBlue,ATL,MIA,0,15,35,14,5,69
6501,Delta,LAX,BOS,22,19,33,1,4,57
6502,JetBlue,ORD,BOS,15,46,45,0,9,100
6503,Delta,ORD,MIA,18,16,27,2,23,68
6504,American,DFW,DEN,8,19,40,12,4,75
6505,Southwest,JFK,BOS,19,25,30,14,9,78
6506,Delta,ATL,MIA,11,58,48,13,13,132
6507,Delta,ORD,DEN,21,44,30,2,8,84
6508,JetBlue,JFK,SEA,12,1,28,12,20,61
6509,JetBlue,LAX,DEN,8,3,48,11,8,70
6510,Southwest,ORD,DEN,0,21,18,13,26,78
6511,United,ORD,SEA,10,37,5,4,27,73
6512,Delta,DFW,MIA,10,50,34,1,12,97
6513,United,LAX,MIA,5,54,0,4,3,61
6514,American,ORD,MIA,3,13,57,1,11,82
6515,Delta,DFW,DEN,22,31,38,6,29,104
6516,Delta,LAX,MIA,23,43,14,2,2,61
6517,Delta,LAX,DEN,18,9,57,12,4,82
6518,JetBlue,ORD,BOS,19,41,34,6,1,82
6519,United,JFK,PHX,7,7,59,10,19,95
6520,Southwest,ATL,PHX,17,41,45,3,20,109
6521,Southwest,ATL,PHX,15,14,47,14,7,82
6522,United,LAX,PHX,21,34,0,5,29,68
6523,JetBlue,JFK,MIA,1,44,6,6,26,82
6524,United,LAX,BOS,12,30,49,7,0,86
6525,Southwest,DFW,DEN,8,39,43,1,28,111
6526,JetBlue,LAX,SEA,17,35,9,13,23,80
6527,United,ATL,MIA,12,1,31,6,15,53
6528,Southwest,ORD,PHX,20,25,1,7,10,43
6529,Southwest,ATL,MIA,8,27,21,7,24,79
6530,Delta,ATL,PHX,2,25,39,0,16,80
6531,JetBlue,ATL,PHX,14,41,41,13,19,114
6532,United,JFK,PHX,7,46,36,3,2,87
6533,American,ATL,MIA,15,21,41,10,28,100
6534,Delta,LAX,MIA,5,13,23,8,5,49
6535,JetBlue,DFW,MIA,15,30,1,8,21,60
6536,United,JFK,MIA,9,35,4,4,21,64
6537,Southwest,JFK,PHX,11,55,37,2,24,118
6538,American,ATL,PHX,20,37,39,7,8,91
6539,United,ATL,PHX,15,50,3,8,13,74
6540,Delta,DFW,BOS,21,56,14,4,4,78
6541,American,ORD,MIA,0,22,49,2,28,101
6542,Southwest,JFK,MIA,22,25,57,10,21,113
6543,Southwest,ATL,MIA,23,38,56,12,1,107
6544,Delta,ORD,PHX,19,52,10,8,2,72
6545,American,ORD,PHX,12,17,17,7,21,62
6546,United,ATL,BOS,19,36,13,4,24,77
6547,United,JFK,BOS,20,17,35,5,16,73
6548,United,ATL,PHX,10,59,59,5,18,141
6549,American,JFK,SEA,11,12,30,13,19,74
6550,Southwest,LAX,PHX,5,49,43,6,1,99
6551,Southwest,ORD,MIA,17,55,57,6,19,137
6552,Delta,ORD,MIA,23,45,51,13,9,118
6553,United,DFW,PHX,8,57,20,1,25,103
6554,United,DFW,MIA,22,29,42,14,5,90
6555,Southwest,ORD,MIA,13,3,25,5,13,46
6556,United,JFK,SEA,23,41,32,4,27,104
6557,JetBlue,ATL,SEA,12,20,33,11,11,75
6558,American,ATL,DEN,20,58,51,1,0,110
6559,United,ATL,PHX,3,34,4,11,17,66
6560,Southwest,JFK,DEN,15,50,50,12,22,134
6561,Delta,JFK,SEA,21,27,40,12,5,84
6562,JetBlue,JFK,PHX,14,5,48,12,19,84
6563,American,DFW,BOS,1,19,6,11,28,64
6564,American,ORD,MIA,17,11,43,1,19,74
6565,American,DFW,MIA,20,54,16,4,18,92
6566,United,DFW,MIA,10,56,10,0,4,70
6567,JetBlue,DFW,SEA,2,55,22,11,9,97
6568,United,JFK,SEA,10,7,28,0,13,48
6569,Delta,JFK,BOS,13,19,4,7,27,57
6570,Southwest,JFK,SEA,21,42,9,7,7,65
6571,Southwest,LAX,SEA,0,21,2,6,21,50
6572,American,ORD,DEN,7,16,13,2,26,57
6573,Delta,ATL,DEN,10,15,11,13,3,42
6574,JetBlue,JFK,BOS,2,55,32,2,11,100
6575,Delta,LAX,DEN,20,42,57,14,26,139
6576,Southwest,LAX,PHX,6,8,23,5,1,37
6577,Delta,JFK,BOS,1,16,29,2,17,64
6578,Southwest,DFW,PHX,0,56,51,2,23,132
6579,Southwest,LAX,MIA,1,20,58,10,3,91
6580,American,LAX,SEA,8,36,47,4,26,113
6581,Delta,ORD,MIA,20,2,52,5,29,88
6582,United,LAX,SEA,20,36,51,7,2,96
6583,United,DFW,PHX,9,32,49,0,28,109
6584,JetBlue,LAX,SEA,3,42,19,5,24,90
6585,JetBlue,ATL,DEN,10,41,27,11,19,98
6586,JetBlue,ATL,DEN,23,53,18,7,1,79
6587,JetBlue,DFW,DEN,1,9,55,11,10,85
6588,JetBlue,LAX,MIA,8,38,32,2,13,85
6589,United,ORD,SEA,9,20,35,14,26,95
6590,Delta,ATL,PHX,13,17,32,9,22,80
6591,Delta,ATL,BOS,2,50,59,10,24,143
6592,Southwest,JFK,DEN,14,23,0,10,25,58
6593,United,ORD,MIA,5,21,52,5,3,81
6594,Southwest,DFW,DEN,7,38,7,5,21,71
6595,American,ATL,BOS,15,28,51,13,15,107
6596,American,ATL,PHX,16,32,55,12,4,103
6597,JetBlue,LAX,PHX,13,2,42,4,15,63
6598,United,DFW,BOS,14,37,47,14,17,115
6599,Delta,ATL,BOS,15,16,22,2,16,56
6600,Delta,ORD,DEN,11,42,58,2,4,106
6601,Southwest,JFK,SEA,12,28,44,9,5,86
6602,Southwest,LAX,MIA,2,39,51,2,24,116
6603,United,ORD,PHX,21,18,40,12,19,89
6604,JetBlue,DFW,PHX,21,43,13,8,21,85
6605,Delta,ATL,PHX,11,8,44,10,22,84
6606,Delta,ATL,PHX,21,51,7,9,25,92
6607,American,DFW,SEA,0,37,11,9,0,57
6608,Southwest,LAX,MIA,19,39,4,1,2,46
6609,American,ORD,MIA,15,43,16,12,9,80
6610,American,ORD,PHX,20,7,15,8,5,35
6611,United,ATL,MIA,1,23,27,14,17,81
6612,American,JFK,PHX,3,32,54,4,26,116
6613,Delta,ATL,MIA,6,48,59,4,26,137
6614,JetBlue,JFK,PHX,14,48,48,8,24,128
6615,Delta,LAX,SEA,1,58,23,11,10,102
6616,United,ORD,SEA,15,37,52,9,16,114
6617,American,DFW,DEN,15,41,52,3,0,96
6618,Delta,DFW,PHX,10,12,57,5,10,84
6619,Delta,LAX,DEN,12,25,18,10,16,69
6620,United,ATL,SEA,11,42,55,6,11,114
6621,Southwest,JFK,DEN,0,6,43,5,27,81
6622,United,JFK,BOS,9,22,39,7,27,95
6623,United,ORD,BOS,10,25,25,10,12,72
6624,JetBlue,LAX,MIA,15,53,6,1,6,66
6625,Delta,ORD,SEA,19,6,1,2,17,26
6626,United,LAX,SEA,21,28,32,13,12,85
6627,Delta,LAX,DEN,22,14,3,1,27,45
6628,Delta,ORD,MIA,14,57,54,13,24,148
6629,American,ATL,MIA,17,59,2,11,7,79
6630,American,JFK,MIA,21,43,51,7,2,103
6631,United,DFW,DEN,5,10,10,1,3,24
6632,American,ATL,DEN,6,16,8,5,8,37
6633,United,ATL,PHX,15,51,40,5,29,125
6634,Southwest,JFK,MIA,1,50,1,6,27,84
6635,Southwest,ORD,SEA,6,41,43,14,15,113
6636,American,ATL,SEA,18,33,23,9,21,86
6637,JetBlue,LAX,PHX,10,10,20,11,12,53
6638,JetBlue,ORD,MIA,22,24,56,9,19,108
6639,Southwest,ATL,MIA,19,34,51,0,15,100
6640,Southwest,LAX,SEA,5,32,50,8,27,117
6641,Southwest,DFW,MIA,11,32,6,5,15,58
6642,Southwest,DFW,DEN,6,9,51,12,2,74
6643,American,LAX,SEA,22,33,37,2,15,87
6644,Southwest,ATL,SEA,8,15,50,12,23,100
6645,Southwest,DFW,PHX,0,35,35,11,0,81
6646,Delta,DFW,SEA,2,41,16,1,10,68
6647,Delta,ATL,DEN,15,36,31,13,24,104
6648,Southwest,JFK,MIA,19,42,3,9,2,56
6649,Southwest,LAX,PHX,11,44,36,12,4,96
6650,United,LAX,BOS,8,47,21,11,10,89
6651,United,JFK,DEN,10,22,40,3,21,86
6652,Southwest,ATL,SEA,9,26,4,0,22,52
6653,JetBlue,LAX,SEA,3,11,51,7,19,88
6654,JetBlue,DFW,DEN,20,16,50,3,5,74
6655,JetBlue,ORD,SEA,15,39,50,14,1,104
6656,American,ATL,SEA,11,54,47,5,14,120
6657,American,ORD,MIA,14,44,56,1,26,127
6658,Delta,DFW,BOS,22,34,58,11,24,127
6659,Delta,LAX,BOS,22,20,3,6,1,30
6660,United,ORD,SEA,2,14,9,1,5,29
6661,American,LAX,PHX,17,47,20,9,20,96
6662,American,JFK,BOS,22,11,38,11,16,76
6663,American,JFK,SEA,21,27,10,14,29,80
6664,Delta,JFK,MIA,0,31,6,12,11,60
6665,Delta,ATL,BOS,22,10,5,0,19,34
6666,Delta,ATL,PHX,7,2,50,3,4,59
6667,United,DFW,BOS,8,24,1,14,7,46
6668,Southwest,DFW,MIA,16,39,28,8,18,93
6669,Delta,LAX,PHX,16,16,54,14,7,91
6670,JetBlue,JFK,BOS,22,7,50,10,3,70
6671,Delta,ATL,PHX,1,43,10,6,4,63
6672,Southwest,ATL,PHX,10,58,25,0,23,106
6673,Delta,DFW,PHX,8,35,55,6,8,104
6674,Delta,ORD,BOS,11,2,24,7,17,50
6675,JetBlue,DFW,SEA,11,41,16,7,8,72
6676,Southwest,ORD,MIA,19,43,58,3,9,113
6677,Delta,ORD,SEA,18,46,53,7,4,110
6678,Southwest,LAX,SEA,4,27,21,8,29,85
6679,Southwest,LAX,SEA,21,42,56,13,9,120
6680,United,JFK,SEA,15,34,2,4,2,42
6681,United,JFK,PHX,6,21,35,1,13,70
6682,American,ATL,PHX,23,4,27,10,3,44
6683,American,ATL,PHX,18,50,9,0,23,82
6684,Southwest,ORD,DEN,16,49,43,10,0,102
6685,JetBlue,ORD,MIA,8,48,8,14,29,99
6686,American,LAX,BOS,23,12,17,8,27,64
6687,United,DFW,PHX,0,33,14,0,19,66
6688,Delta,ORD,MIA,7,27,24,2,26,79
6689,American,ATL,DEN,6,17,36,6,22,81
6690,Delta,ATL,PHX,0,26,25,11,26,88
6691,JetBlue,ATL,BOS,8,29,26,12,9,76
6692,JetBlue,JFK,MIA,18,54,46,9,9,118
6693,American,LAX,MIA,17,36,14,12,26,88
6694,United,LAX,BOS,3,20,30,9,9,68
6695,American,JFK,MIA,7,21,52,6,8,87
6696,Delta,LAX,PHX,2,16,54,8,10,88
6697,Delta,LAX,PHX,18,57,3,5,7,72
6698,Southwest,ORD,BOS,17,1,50,14,0,65
6699,Delta,ATL,PHX,16,57,56,7,29,149
6700,JetBlue,ATL,BOS,7,52,42,3,15,112
6701,United,LAX,MIA,20,11,54,6,17,88
6702,American,LAX,BOS,6,52,58,0,2,112
6703,JetBlue,LAX,PHX,8,10,53,13,6,82
6704,American,DFW,PHX,7,25,56,9,11,101
6705,JetBlue,ATL,MIA,7,34,44,11,3,92
6706,Delta,ATL,PHX,13,2,56,0,0,58
6707,Southwest,ATL,PHX,23,27,8,8,21,64
6708,American,LAX,SEA,4,8,2,10,13,33
6709,Delta,DFW,PHX,5,10,55,9,27,101
6710,United,DFW,MIA,22,40,1,12,4,57
6711,Southwest,ATL,BOS,9,47,49,8,23,127
6712,Southwest,LAX,DEN,8,59,23,12,11,105
6713,United,JFK,MIA,2,29,45,9,17,100
6714,Delta,LAX,SEA,12,45,50,8,7,110
6715,JetBlue,LAX,PHX,3,57,55,3,21,136
6716,American,DFW,MIA,19,13,1,2,23,39
6717,United,DFW,SEA,15,33,32,7,10,82
6718,JetBlue,DFW,SEA,6,0,34,11,10,55
6719,Southwest,ORD,SEA,19,50,6,8,21,85
6720,United,DFW,PHX,3,51,25,11,6,93
6721,Delta,DFW,MIA,15,50,3,7,1,61
6722,Delta,JFK,BOS,10,29,33,8,5,75
6723,American,LAX,SEA,6,50,39,13,7,109
6724,Delta,ATL,DEN,20,59,22,14,14,109
6725,Delta,ATL,MIA,6,39,6,12,25,82
6726,United,JFK,PHX,8,27,17,13,27,84
6727,Southwest,JFK,BOS,5,54,12,2,25,93
6728,Delta,LAX,BOS,16,41,52,14,27,134
6729,Delta,LAX,SEA,0,0,15,14,18,47
6730,Delta,DFW,PHX,10,15,39,7,21,82
6731,Southwest,LAX,PHX,2,57,29,5,18,109
6732,JetBlue,DFW,DEN,5,6,47,14,3,70
6733,JetBlue,JFK,DEN,13,15,11,7,5,38
6734,United,LAX,MIA,7,53,32,3,6,94
6735,American,ORD,SEA,10,14,38,1,12,65
6736,Southwest,ATL,PHX,0,32,52,12,25,121
6737,American,DFW,SEA,9,50,33,5,23,111
6738,American,LAX,MIA,13,12,21,6,5,44
6739,Southwest,LAX,BOS,1,58,51,0,19,128
6740,Southwest,LAX,DEN,1,18,3,9,13,43
6741,JetBlue,LAX,BOS,7,35,12,0,3,50
6742,United,LAX,PHX,17,31,15,12,29,87
6743,Delta,LAX,PHX,20,1,57,3,29,90
6744,American,DFW,DEN,18,33,50,2,18,103
6745,United,DFW,MIA,11,7,48,8,4,67
6746,Delta,LAX,DEN,17,22,35,2,8,67
6747,Delta,LAX,BOS,1,45,49,9,28,131
6748,Delta,JFK,MIA,21,46,31,6,20,103
6749,Delta,LAX,SEA,15,53,44,8,24,129
6750,JetBlue,DFW,DEN,18,6,38,10,14,68
6751,JetBlue,ATL,SEA,23,34,14,8,19,75
6752,American,LAX,BOS,23,20,55,0,18,93
6753,Southwest,DFW,DEN,14,49,16,14,13,92
6754,American,LAX,BOS,9,17,32,4,29,82
6755,Southwest,JFK,PHX,17,45,9,9,26,89
6756,United,JFK,PHX,23,15,2,9,4,30
6757,JetBlue,ORD,BOS,9,7,16,3,11,37
6758,Southwest,DFW,SEA,9,54,17,1,23,95
6759,JetBlue,ORD,BOS,6,16,22,13,3,54
6760,Southwest,JFK,PHX,13,14,59,7,23,103
6761,Southwest,JFK,SEA,14,15,45,9,15,84
6762,United,LAX,SEA,8,40,42,7,19,108
6763,American,JFK,MIA,12,59,59,12,10,140
6764,JetBlue,ORD,DEN,8,42,27,10,11,90
6765,Delta,DFW,DEN,5,12,39,8,24,83
6766,United,LAX,BOS,7,47,27,0,23,97
6767,Southwest,LAX,DEN,13,43,26,2,6,77
6768,Southwest,DFW,DEN,7,46,15,7,28,96
6769,JetBlue,JFK,DEN,0,54,9,14,10,87
6770,Southwest,LAX,DEN,0,31,22,9,6,68
6771,American,DFW,PHX,15,39,4,5,26,74
6772,American,DFW,SEA,6,12,22,13,20,67
6773,JetBlue,JFK,PHX,16,51,41,9,18,119
6774,JetBlue,JFK,MIA,19,31,48,9,17,105
6775,JetBlue,ATL,MIA,7,59,45,8,8,120
6776,American,LAX,PHX,18,41,2,8,27,78
6777,JetBlue,ORD,PHX,20,39,23,13,9,84
6778,JetBlue,JFK,DEN,22,37,0,6,10,53
6779,JetBlue,ATL,DEN,14,15,29,4,12,60
6780,Delta,ORD,SEA,17,37,17,14,23,91
6781,JetBlue,JFK,DEN,3,21,22,5,26,74
6782,United,ATL,MIA,1,9,35,0,16,60
6783,United,ORD,SEA,9,0,19,3,28,50
6784,American,JFK,PHX,9,25,21,9,24,79
6785,Southwest,JFK,MIA,13,26,39,7,19,91
6786,United,ORD,SEA,15,11,27,14,22,74
6787,Southwest,ATL,SEA,23,27,47,1,18,93
6788,United,JFK,PHX,4,45,31,7,16,99
6789,Delta,ORD,BOS,12,14,10,13,15,52
6790,United,DFW,MIA,3,35,18,14,17,84
6791,JetBlue,LAX,DEN,4,6,48,4,12,70
6792,American,ORD,PHX,4,14,50,0,6,70
6793,Southwest,LAX,DEN,23,19,21,10,11,61
6794,JetBlue,DFW,DEN,22,2,51,0,19,72
6795,Southwest,ORD,MIA,6,22,50,0,27,99
6796,United,LAX,MIA,8,40,20,10,13,83
6797,Southwest,JFK,SEA,20,48,40,9,10,107
6798,United,LAX,MIA,17,9,35,9,13,66
6799,Southwest,JFK,SEA,2,52,17,0,15,84
6800,Southwest,ATL,SEA,23,48,29,7,13,97
6801,Southwest,DFW,BOS,22,39,47,9,8,103
6802,United,ORD,MIA,22,46,4,10,25,85
6803,Delta,JFK,BOS,12,27,55,5,22,109
6804,American,DFW,PHX,1,12,13,5,4,34
6805,JetBlue,DFW,PHX,0,6,44,8,25,83
6806,Delta,JFK,MIA,17,44,21,1,13,79
6807,JetBlue,DFW,BOS,20,57,47,13,9,126
6808,Southwest,ORD,SEA,18,49,48,7,16,120
6809,JetBlue,ORD,PHX,17,41,36,0,9,86
6810,Delta,LAX,MIA,6,33,54,13,24,124
6811,United,DFW,SEA,14,56,41,5,20,122
6812,JetBlue,JFK,DEN,20,25,31,6,19,81
6813,Delta,ORD,BOS,8,56,16,10,23,105
6814,American,ATL,MIA,21,39,40,5,5,89
6815,JetBlue,DFW,PHX,9,17,58,5,3,83
6816,United,JFK,BOS,13,35,53,10,2,100
6817,JetBlue,JFK,MIA,11,16,2,12,14,44
6818,Delta,DFW,SEA,0,28,57,9,20,114
6819,Southwest,JFK,DEN,1,18,20,2,19,59
6820,American,JFK,MIA,15,17,7,11,6,41
6821,Delta,LAX,MIA,0,17,3,1,23,44
6822,American,JFK,BOS,23,40,41,11,13,105
6823,Delta,ATL,SEA,12,7,53,14,17,91
6824,American,ATL,DEN,5,22,7,2,20,51
6825,United,DFW,BOS,8,51,10,6,8,75
6826,Delta,LAX,PHX,17,10,8,13,3,34
6827,Southwest,DFW,MIA,12,42,47,11,13,113
6828,Delta,JFK,MIA,19,32,50,6,16,104
6829,Southwest,LAX,SEA,7,11,53,13,13,90
6830,Southwest,LAX,MIA,10,0,21,6,21,48
6831,United,DFW,DEN,4,32,52,2,15,101
6832,JetBlue,JFK,PHX,21,30,45,5,28,108
6833,Southwest,LAX,MIA,20,29,21,2,29,81
6834,American,LAX,PHX,8,27,3,11,24,65
6835,American,ATL,PHX,7,0,50,13,0,63
6836,United,JFK,SEA,7,12,8,8,10,38
6837,Southwest,JFK,PHX,16,20,12,10,24,66
6838,American,ORD,BOS,7,35,59,9,26,129
6839,Delta,JFK,DEN,7,36,4,14,17,71
6840,JetBlue,DFW,MIA,5,49,9,3,13,74
6841,United,JFK,MIA,21,30,30,7,21,88
6842,American,ATL,BOS,14,47,46,10,28,131
6843,JetBlue,ATL,BOS,17,13,40,7,6,66
6844,United,ORD,BOS,12,4,16,6,2,28
6845,JetBlue,DFW,DEN,7,30,25,5,20,80
6846,American,DFW,MIA,14,11,51,11,17,90
6847,JetBlue,ORD,MIA,2,14,53,0,22,89
6848,JetBlue,JFK,PHX,14,36,25,11,26,98
6849,United,ORD,MIA,22,36,23,3,3,65
6850,JetBlue,JFK,SEA,22,45,13,2,24,84
6851,Southwest,DFW,MIA,17,59,12,1,12,84
6852,JetBlue,ATL,SEA,11,47,24,4,14,89
6853,JetBlue,LAX,BOS,12,1,11,11,10,33
6854,United,LAX,PHX,18,6,59,8,25,98
6855,Delta,JFK,PHX,5,4,9,2,23,38
6856,American,JFK,DEN,21,43,42,12,18,115
6857,Southwest,ORD,MIA,12,21,0,7,27,55
6858,American,LAX,MIA,14,6,45,5,26,82
6859,Southwest,ATL,PHX,8,24,16,0,16,56
6860,United,JFK,PHX,4,33,22,1,21,77
6861,American,ORD,MIA,16,45,5,3,12,65
6862,Southwest,LAX,MIA,14,17,14,3,29,63
6863,United,ATL,DEN,6,46,35,7,16,104
6864,Southwest,JFK,SEA,14,54,37,1,9,101
6865,United,LAX,SEA,21,0,38,1,26,65
6866,JetBlue,JFK,DEN,8,6,54,3,28,91
6867,American,DFW,MIA,19,23,11,9,0,43
6868,JetBlue,LAX,SEA,17,30,50,10,21,111
6869,Delta,LAX,DEN,0,24,54,3,11,92
6870,Southwest,ORD,BOS,9,53,21,0,26,100
6871,United,LAX,PHX,17,52,35,7,0,94
6872,Delta,ATL,SEA,20,40,27,14,29,110
6873,United,DFW,DEN,21,46,57,8,11,122
6874,American,ORD,DEN,1,32,15,4,17,68
6875,Delta,ORD,DEN,21,16,34,10,27,87
6876,Southwest,JFK,DEN,1,12,0,7,9,28
6877,American,ORD,DEN,12,40,13,5,3,61
6878,United,JFK,PHX,14,3,6,14,25,48
6879,JetBlue,LAX,BOS,4,7,52,5,23,87
6880,Southwest,DFW,BOS,13,46,7,0,12,65
6881,American,ATL,PHX,12,2,25,2,27,56
6882,Southwest,JFK,BOS,12,16,43,8,22,89
6883,Delta,JFK,MIA,0,3,38,1,12,54
6884,Southwest,ORD,DEN,4,39,8,6,21,74
6885,Delta,JFK,MIA,18,3,8,13,28,52
6886,United,ORD,BOS,1,20,42,2,17,81
6887,Delta,JFK,MIA,9,12,20,4,7,43
6888,United,DFW,DEN,20,23,23,0,29,75
6889,United,LAX,MIA,1,6,34,4,26,70
6890,United,LAX,PHX,17,36,1,6,11,54
6891,American,ATL,PHX,16,36,23,8,28,95
6892,American,DFW,PHX,5,45,59,2,25,131
6893,Southwest,ORD,PHX,0,41,14,2,6,63
6894,American,DFW,SEA,22,40,39,11,6,96
6895,American,JFK,PHX,10,28,57,2,9,96
6896,Southwest,ATL,SEA,23,51,47,7,2,107
6897,Southwest,LAX,DEN,18,3,45,11,12,71
6898,American,DFW,SEA,2,54,55,4,5,118
6899,United,ORD,MIA,21,20,38,7,17,82
6900,Southwest,ORD,DEN,11,14,34,7,24,79
6901,United,ORD,MIA,12,20,37,7,19,83
6902,Southwest,JFK,MIA,10,57,59,1,18,135
6903,Delta,ORD,SEA,7,29,39,9,15,92
6904,Delta,DFW,DEN,22,38,28,1,23,90
6905,United,JFK,MIA,23,33,35,14,8,90
6906,Delta,ORD,MIA,9,12,42,9,12,75
6907,American,JFK,MIA,17,24,53,9,5,91
6908,JetBlue,ATL,DEN,16,27,16,12,28,83
6909,United,LAX,SEA,3,44,57,4,27,132
6910,American,DFW,DEN,19,36,53,8,5,102
6911,JetBlue,ORD,DEN,16,52,11,8,18,89
6912,JetBlue,DFW,DEN,15,1,7,4,23,35
6913,American,ORD,SEA,2,18,36,1,9,64
6914,JetBlue,DFW,PHX,15,40,30,12,11,93
6915,JetBlue,LAX,DEN,3,24,11,10,13,58
6916,Delta,LAX,DEN,3,56,4,6,26,92
6917,Delta,ATL,DEN,23,56,59,10,21,146
6918,Southwest,JFK,DEN,10,21,52,2,0,75
6919,Southwest,DFW,SEA,11,24,28,10,1,63
6920,Delta,LAX,DEN,8,53,6,4,0,63
6921,Southwest,LAX,BOS,16,50,51,14,9,124
6922,Delta,ORD,MIA,3,18,8,10,12,48
6923,Southwest,DFW,DEN,6,55,11,12,24,102
6924,JetBlue,ATL,PHX,8,19,41,5,28,93
6925,Southwest,ATL,MIA,7,36,0,4,26,66
6926,JetBlue,DFW,SEA,23,28,15,9,21,73
6927,United,LAX,MIA,0,22,21,10,5,58
6928,JetBlue,ATL,DEN,4,45,37,2,18,102
6929,United,ORD,MIA,11,1,1,14,17,33
6930,American,JFK,MIA,8,58,45,3,1,107
6931,American,DFW,DEN,12,38,8,2,13,61
6932,Delta,DFW,SEA,12,45,13,6,11,75
6933,Delta,ORD,PHX,9,44,33,13,22,112
6934,American,LAX,DEN,5,30,8,14,7,59
6935,American,ATL,PHX,12,8,22,9,5,44
6936,Delta,DFW,DEN,20,23,29,5,27,84
6937,Delta,DFW,DEN,18,58,56,7,8,129
6938,American,JFK,SEA,2,47,37,8,25,117
6939,Delta,DFW,DEN,17,49,8,12,5,74
6940,United,ORD,PHX,13,17,53,14,21,105
6941,United,ATL,MIA,14,30,19,2,15,66
6942,Southwest,LAX,SEA,3,42,7,11,5,65
6943,United,DFW,SEA,20,9,20,1,8,38
6944,Delta,ATL,SEA,9,34,13,12,12,71
6945,Delta,JFK,SEA,8,45,18,14,20,97
6946,Southwest,DFW,DEN,6,41,9,5,28,83
6947,Delta,DFW,SEA,11,54,3,5,19,81
6948,JetBlue,DFW,BOS,8,34,35,6,2,77
6949,JetBlue,JFK,BOS,21,40,47,13,1,101
6950,JetBlue,JFK,BOS,21,48,20,5,2,75
6951,JetBlue,JFK,SEA,7,24,12,3,20,59
6952,Southwest,ATL,DEN,12,28,31,14,26,99
6953,Delta,DFW,PHX,5,22,4,1,18,45
6954,Southwest,ATL,BOS,6,30,16,4,0,50
6955,American,ATL,DEN,10,12,51,1,21,85
6956,Delta,LAX,SEA,15,19,10,7,0,36
6957,American,ORD,BOS,19,50,55,9,24,138
6958,Delta,JFK,BOS,2,21,19,8,11,59
6959,Southwest,LAX,SEA,20,41,23,7,26,97
6960,Southwest,LAX,PHX,2,30,4,1,10,45
6961,Southwest,ORD,DEN,19,37,24,8,12,81
6962,United,DFW,SEA,7,51,23,3,12,89
6963,JetBlue,JFK,PHX,3,17,17,5,20,59
6964,JetBlue,ORD,DEN,11,0,35,14,16,65
6965,American,ATL,PHX,7,8,29,0,23,60
6966,United,LAX,DEN,16,23,24,3,23,73
6967,American,ORD,MIA,20,34,19,13,19,85
6968,American,JFK,SEA,22,30,37,6,15,88
6969,United,LAX,SEA,5,4,31,3,5,43
6970,United,DFW,BOS,9,4,2,9,27,42
6971,United,JFK,MIA,7,3,21,13,21,58
6972,Southwest,ORD,BOS,11,53,55,12,17,137
6973,United,LAX,BOS,10,53,13,12,24,102
6974,United,DFW,MIA,19,11,54,11,4,80
6975,American,LAX,BOS,19,13,42,14,12,81
6976,JetBlue,JFK,PHX,9,29,37,11,23,100
6977,Southwest,ORD,BOS,7,5,0,14,19,38
6978,Southwest,DFW,DEN,7,45,7,11,5,68
6979,Delta,JFK,MIA,23,4,15,8,2,29
6980,United,ORD,PHX,20,29,18,12,14,73
6981,American,ATL,BOS,4,9,34,2,20,65
6982,United,JFK,BOS,17,39,4,6,5,54
6983,Delta,DFW,DEN,11,52,0,9,16,77
6984,Southwest,DFW,SEA,20,18,29,11,26,84
6985,Delta,ORD,DEN,5,25,17,9,1,52
6986,American,JFK,BOS,19,31,48,0,26,105
6987,American,JFK,SEA,16,22,13,11,7,53
6988,American,LAX,MIA,19,24,10,5,14,53
6989,American,DFW,SEA,5,4,13,13,2,32
6990,American,ORD,SEA,0,5,50,6,4,65
6991,United,LAX,BOS,3,32,7,14,1,54
6992,Delta,ATL,MIA,6,8,15,2,9,34
6993,United,DFW,PHX,20,3,50,7,26,86
6994,JetBlue,ORD,BOS,10,54,56,10,24,144
6995,United,DFW,MIA,14,39,46,8,12,105
6996,American,ATL,BOS,22,52,19,1,19,91
6997,American,ORD,SEA,12,1,22,0,12,35
6998,American,DFW,SEA,0,55,36,10,9,110
6999,United,ATL,DEN,22,0,6,11,16,33
7000,United,DFW,MIA,21,58,18,10,10,96
7001,Delta,JFK,SEA,2,29,56,3,27,115
7002,JetBlue,DFW,SEA,4,33,32,10,2,77
7003,JetBlue,DFW,SEA,8,44,14,0,13,71
7004,American,LAX,DEN,23,24,11,10,7,52
7005,JetBlue,ATL,DEN,9,1,14,6,7,28
7006,Delta,JFK,BOS,8,13,58,1,1,73
7007,American,LAX,MIA,2,29,35,8,3,75
7008,Southwest,ATL,DEN,18,43,36,14,29,122
7009,United,ORD,BOS,14,53,37,7,0,97
7010,American,JFK,SEA,4,20,19,4,13,56
7011,JetBlue,ORD,MIA,19,15,57,11,6,89
7012,American,JFK,PHX,7,56,4,3,21,84
7013,United,ATL,MIA,3,16,2,5,19,42
7014,American,LAX,SEA,23,46,40,6,7,99
7015,Southwest,DFW,PHX,0,44,16,12,18,90
7016,Southwest,ATL,BOS,15,46,12,6,1,65
7017,JetBlue,ORD,SEA,1,46,1,1,28,76
7018,JetBlue,LAX,SEA,19,10,59,14,8,91
7019,Delta,DFW,MIA,22,25,14,3,11,53
7020,Delta,LAX,MIA,22,53,37,7,10,107
7021,American,ATL,SEA,14,10,53,10,28,101
7022,Delta,LAX,MIA,0,26,50,5,20,101
7023,Southwest,DFW,DEN,17,46,37,1,0,84
7024,American,ORD,BOS,20,58,53,14,9,134
7025,JetBlue,ATL,PHX,8,6,52,2,9,69
7026,Delta,JFK,SEA,22,35,0,9,3,47
7027,United,DFW,SEA,4,8,28,11,28,75
7028,JetBlue,ATL,SEA,6,32,25,9,26,92
7029,American,ORD,BOS,10,0,32,11,14,57
7030,JetBlue,LAX,DEN,17,27,41,13,26,107
7031,JetBlue,DFW,MIA,4,24,44,3,23,94
7032,Southwest,ATL,BOS,3,50,7,4,26,87
7033,United,LAX,BOS,0,59,18,0,5,82
7034,United,DFW,BOS,3,19,5,10,28,62
7035,Southwest,JFK,MIA,11,37,44,9,5,95
7036,Southwest,LAX,PHX,18,29,16,5,14,64
7037,United,ORD,BOS,13,13,39,3,27,82
7038,American,LAX,SEA,2,56,18,13,15,102
7039,American,LAX,BOS,16,6,3,9,7,25
7040,Delta,ORD,PHX,23,14,22,5,26,67
7041,Southwest,LAX,PHX,5,21,28,12,14,75
7042,Delta,ORD,MIA,17,15,29,6,18,68
7043,United,JFK,SEA,9,53,55,0,10,118
7044,Delta,ATL,DEN,3,36,19,6,8,69
7045,Delta,LAX,BOS,18,56,5,12,2,75
7046,Delta,JFK,DEN,14,46,15,2,9,72
7047,United,DFW,BOS,10,0,24,5,24,53
7048,Delta,DFW,DEN,15,48,25,0,29,102
7049,JetBlue,LAX,BOS,23,1,17,4,16,38
7050,Delta,JFK,BOS,2,41,28,12,6,87
7051,Southwest,LAX,SEA,4,28,58,5,14,105
7052,American,JFK,SEA,7,52,52,0,16,120
7053,American,ORD,SEA,1,56,18,8,18,100
7054,JetBlue,ATL,SEA,12,39,15,2,20,76
7055,United,DFW,SEA,14,4,14,0,8,26
7056,JetBlue,ORD,SEA,13,50,20,7,11,88
7057,American,LAX,SEA,12,54,48,5,11,118
7058,Southwest,JFK,SEA,5,11,14,9,4,38
7059,Delta,DFW,BOS,12,39,8,12,17,76
7060,American,DFW,MIA,4,18,50,1,14,83
7061,United,LAX,DEN,11,51,58,6,18,133
7062,United,DFW,DEN,20,51,1,7,8,67
7063,Delta,DFW,SEA,20,43,47,6,3,99
7064,Delta,LAX,BOS,14,3,22,12,13,50
7065,JetBlue,ATL,PHX,1,10,7,8,20,45
7066,American,DFW,DEN,6,57,56,8,16,137
7067,JetBlue,JFK,DEN,1,16,36,12,28,92
7068,JetBlue,DFW,BOS,18,7,31,0,18,56
7069,Delta,LAX,BOS,17,5,46,12,18,81
7070,American,DFW,PHX,9,0,49,4,28,81
7071,JetBlue,LAX,DEN,13,5,21,8,7,41
7072,JetBlue,ORD,DEN,20,58,33,0,20,111
7073,United,ATL,DEN,9,29,55,3,3,90
7074,United,DFW,PHX,9,22,0,7,2,31
7075,United,ORD,SEA,1,50,58,4,0,112
7076,Southwest,ORD,DEN,6,41,16,8,5,70
7077,Delta,DFW,PHX,4,47,54,0,6,107
7078,American,ORD,BOS,6,4,47,6,28,85
7079,American,ORD,DEN,23,13,11,12,9,45
7080,JetBlue,ORD,BOS,0,38,9,4,21,72
7081,Southwest,DFW,SEA,11,21,57,3,0,81
7082,Southwest,ATL,SEA,14,39,14,5,24,82
7083,JetBlue,DFW,SEA,9,7,14,10,6,37
7084,United,JFK,SEA,19,35,14,4,4,57
7085,JetBlue,ORD,SEA,1,33,16,5,7,61
7086,United,ATL,DEN,14,38,29,2,6,75
7087,JetBlue,JFK,SEA,17,38,59,4,13,114
7088,Delta,JFK,SEA,17,42,41,6,18,107
7089,Delta,DFW,BOS,4,38,20,3,14,75
7090,JetBlue,DFW,MIA,9,17,32,6,17,72
7091,JetBlue,ORD,DEN,13,47,17,5,19,88
7092,JetBlue,LAX,PHX,5,51,48,3,20,122
7093,Southwest,ORD,DEN,9,26,32,4,5,67
7094,Delta,JFK,MIA,12,40,42,7,18,107
7095,American,DFW,BOS,8,53,42,1,10,106
7096,American,DFW,DEN,23,49,51,5,22,127
7097,United,LAX,MIA,14,23,36,5,16,80
7098,JetBlue,JFK,DEN,2,46,22,5,11,84
7099,American,ORD,MIA,14,4,13,12,25,54
7100,American,LAX,MIA,16,5,40,14,5,64
7101,American,JFK,BOS,3,36,19,9,25,89
7102,American,LAX,SEA,3,19,51,8,1,79
7103,American,JFK,DEN,5,1,6,12,14,33
7104,United,LAX,PHX,7,47,31,4,10,92
7105,Delta,JFK,MIA,23,51,44,11,0,106
7106,Southwest,ORD,DEN,13,3,26,12,23,64
7107,Southwest,JFK,MIA,18,54,7,7,25,93
7108,Delta,LAX,BOS,23,44,34,6,24,108
7109,American,ATL,BOS,22,30,16,2,2,50
7110,Southwest,ATL,MIA,14,33,52,14,1,100
7111,Southwest,DFW,PHX,1,13,57,13,12,95
7112,United,ATL,DEN,17,20,33,6,20,79
7113,United,DFW,MIA,23,13,7,4,5,29
7114,JetBlue,JFK,SEA,11,20,27,9,14,70
7115,Delta,DFW,DEN,10,0,26,10,25,61
7116,Southwest,JFK,SEA,4,56,38,5,11,110
7117,Southwest,JFK,PHX,0,25,33,10,17,85
7118,JetBlue,LAX,SEA,12,10,27,0,5,42
7119,Delta,JFK,MIA,23,54,55,3,13,125
7120,Delta,DFW,DEN,13,45,9,1,25,80
7121,JetBlue,ATL,SEA,22,15,38,2,5,60
7122,American,ATL,BOS,16,15,6,0,16,37
7123,Delta,JFK,MIA,10,58,36,9,10,113
7124,United,LAX,PHX,22,22,37,9,4,72
7125,United,ATL,SEA,21,51,22,1,10,84
7126,American,LAX,SEA,22,44,33,6,27,110
7127,American,ORD,DEN,17,48,45,9,21,123
7128,Southwest,JFK,MIA,2,44,38,1,27,110
7129,United,LAX,BOS,13,47,45,7,6,105
7130,Delta,LAX,DEN,5,3,42,10,29,84
7131,United,ATL,MIA,8,34,32,0,12,78
7132,JetBlue,LAX,DEN,14,13,44,8,0,65
7133,American,ORD,BOS,0,27,22,10,29,88
7134,United,LAX,SEA,9,5,33,7,20,65
7135,American,DFW,SEA,3,33,48,4,24,109
7136,United,JFK,PHX,22,39,52,7,0,98
7137,United,JFK,PHX,9,49,54,14,7,124
7138,Delta,ORD,MIA,18,0,48,14,24,86
7139,Delta,LAX,BOS,3,3,0,13,0,16
7140,American,ATL,DEN,13,6,35,5,6,52
7141,JetBlue,JFK,MIA,16,4,9,0,10,23
7142,American,LAX,MIA,20,17,13,10,29,69
7143,Southwest,JFK,SEA,2,45,21,5,15,86
7144,JetBlue,LAX,BOS,13,19,48,11,23,101
7145,American,LAX,MIA,0,49,10,4,23,86
7146,Delta,ORD,BOS,11,46,25,5,13,89
7147,Delta,ATL,MIA,18,34,8,4,12,58
7148,Southwest,ORD,SEA,4,43,5,2,27,77
7149,JetBlue,LAX,PHX,7,3,11,9,6,29
7150,Southwest,ATL,BOS,7,50,17,13,23,103
7151,American,ATL,PHX,21,31,1,14,1,47
7152,United,LAX,BOS,15,55,38,1,1,95
7153,American,ORD,MIA,1,35,47,6,18,106
7154,American,JFK,DEN,4,28,2,6,28,64
7155,Delta,JFK,PHX,22,2,57,13,18,90
7156,United,JFK,DEN,17,41,22,3,21,87
7157,United,ATL,DEN,1,49,6,14,25,94
7158,American,ORD,BOS,11,16,57,8,10,91
7159,JetBlue,LAX,BOS,21,58,2,14,23,97
7160,United,LAX,PHX,14,58,17,4,19,98
7161,Southwest,DFW,PHX,15,28,8,9,0,45
7162,American,LAX,MIA,5,51,4,6,15,76
7163,Southwest,LAX,BOS,8,25,42,1,5,73
7164,Southwest,DFW,MIA,9,52,46,9,4,111
7165,American,ORD,PHX,22,40,40,7,2,89
7166,JetBlue,DFW,BOS,7,48,49,11,9,117
7167,Southwest,ORD,MIA,11,1,12,12,4,29
7168,JetBlue,LAX,MIA,23,42,54,0,29,125
7169,Delta,LAX,SEA,21,26,46,4,7,83
7170,Delta,DFW,SEA,22,47,21,1,2,71
7171,JetBlue,ORD,SEA,23,44,55,5,27,131
7172,JetBlue,ORD,BOS,1,8,1,13,9,31
7173,American,LAX,DEN,8,58,59,9,25,151
7174,Southwest,ORD,MIA,20,31,43,2,25,101
7175,JetBlue,DFW,PHX,22,12,54,3,17,86
7176,JetBlue,ORD,MIA,8,6,40,10,12,68
7177,Southwest,LAX,MIA,12,3,38,5,28,74
7178,Southwest,JFK,MIA,10,33,12,13,13,71
7179,Delta,ATL,PHX,10,41,27,6,27,101
7180,JetBlue,JFK,SEA,20,34,6,3,19,62
7181,American,LAX,DEN,4,18,1,1,1,21
7182,United,DFW,BOS,20,15,54,8,1,78
7183,Delta,DFW,SEA,14,33,53,0,0,86
7184,United,JFK,MIA,8,42,40,5,24,111
7185,Southwest,LAX,PHX,5,3,14,13,8,38
7186,United,ATL,SEA,22,35,35,1,23,94
7187,JetBlue,ATL,DEN,18,25,4,0,28,57
7188,United,JFK,MIA,21,59,34,8,7,108
7189,United,LAX,SEA,0,11,39,14,23,87
7190,Delta,ATL,PHX,19,36,5,8,4,53
7191,American,ATL,SEA,14,14,46,14,7,81
7192,Southwest,ATL,PHX,4,49,21,0,12,82
7193,Southwest,JFK,DEN,19,12,1,8,6,27
7194,JetBlue,DFW,BOS,21,29,25,6,17,77
7195,United,DFW,DEN,18,19,29,5,9,62
7196,United,DFW,MIA,16,43,12,6,27,88
7197,Delta,ORD,SEA,1,9,34,3,22,68
7198,Delta,ATL,SEA,2,52,34,11,23,120
7199,Southwest,DFW,DEN,17,37,50,2,15,104
7200,Delta,JFK,BOS,20,39,43,12,20,114
7201,JetBlue,JFK,DEN,8,55,14,7,9,85
7202,Delta,ATL,BOS,5,29,6,12,6,53
7203,United,JFK,PHX,20,37,38,7,0,82
7204,Southwest,ORD,DEN,21,33,34,2,13,82
7205,Southwest,LAX,PHX,1,41,2,13,2,58
7206,American,DFW,PHX,1,57,4,4,20,85
7207,JetBlue,ORD,DEN,3,33,24,6,11,74
7208,American,DFW,BOS,15,36,57,5,3,101
7209,Delta,DFW,SEA,2,19,42,9,16,86
7210,JetBlue,LAX,SEA,15,7,29,11,18,65
7211,American,ATL,DEN,3,40,31,14,14,99
7212,United,ATL,BOS,0,54,24,3,22,103
7213,Delta,ATL,PHX,5,23,1,14,3,41
7214,United,LAX,DEN,14,31,3,8,27,69
7215,American,ATL,DEN,18,44,46,13,13,116
7216,American,ORD,PHX,22,6,54,7,7,74
7217,United,ORD,MIA,19,0,44,10,3,57
7218,United,ORD,MIA,3,8,38,2,8,56
7219,Southwest,JFK,PHX,14,39,2,10,9,60
7220,Delta,DFW,PHX,3,9,46,2,26,83
7221,United,ATL,BOS,3,12,18,7,27,64
7222,American,ATL,MIA,15,59,34,0,12,105
7223,JetBlue,JFK,PHX,4,26,57,11,8,102
7224,United,JFK,PHX,4,50,56,9,25,140
7225,United,ORD,DEN,17,13,39,10,7,69
7226,United,LAX,PHX,16,38,21,6,15,80
7227,Southwest,ATL,MIA,20,46,6,6,26,84
7228,Southwest,JFK,MIA,14,1,4,4,18,27
7229,Southwest,ATL,DEN,22,49,20,0,4,73
7230,Southwest,ORD,PHX,12,22,18,1,24,65
7231,Delta,LAX,PHX,5,58,56,12,6,132
7232,American,JFK,PHX,19,38,52,12,0,102
7233,JetBlue,ATL,DEN,15,26,44,11,3,84
7234,American,ATL,PHX,17,12,20,11,29,72
7235,Delta,ATL,MIA,19,25,21,8,22,76
7236,JetBlue,DFW,BOS,4,11,49,9,13,82
7237,United,JFK,MIA,4,6,29,9,15,59
7238,JetBlue,ATL,PHX,2,28,25,3,18,74
7239,Southwest,ORD,SEA,8,0,39,1,17,57
7240,JetBlue,ORD,BOS,13,0,56,8,6,70
7241,Southwest,ORD,BOS,15,50,11,10,7,78
7242,JetBlue,DFW,PHX,0,38,1,8,12,59
7243,JetBlue,JFK,BOS,14,27,37,11,19,94
7244,United,LAX,PHX,17,50,43,0,7,100
7245,American,LAX,MIA,17,28,43,3,13,87
7246,JetBlue,LAX,DEN,21,2,45,10,2,59
7247,Southwest,ORD,MIA,22,21,56,14,0,91
7248,Southwest,ATL,PHX,8,41,6,13,23,83
7249,United,DFW,PHX,21,52,6,0,22,80
7250,Southwest,DFW,MIA,14,45,21,14,20,100
7251,American,ATL,BOS,21,37,7,2,27,73
7252,Delta,LAX,MIA,17,0,28,7,15,50
7253,JetBlue,LAX,DEN,11,30,17,3,8,58
7254,JetBlue,JFK,MIA,0,59,57,2,16,134
7255,United,DFW,MIA,1,13,27,7,8,55
7256,Delta,ORD,SEA,13,37,56,13,25,131
7257,United,DFW,DEN,12,44,14,1,5,64
7258,Delta,JFK,PHX,1,21,1,9,29,60
7259,JetBlue,LAX,PHX,5,31,53,11,28,123
7260,United,ORD,PHX,3,49,49,6,11,115
7261,Delta,ATL,SEA,5,50,5,8,24,87
7262,American,LAX,PHX,8,33,58,9,25,125
7263,Delta,ATL,MIA,21,25,39,0,21,85
7264,Delta,JFK,BOS,11,14,9,2,27,52
7265,Southwest,DFW,DEN,11,21,8,12,12,53
7266,United,DFW,PHX,1,12,25,2,3,42
7267,Delta,ATL,DEN,7,7,4,5,15,31
7268,JetBlue,ORD,PHX,1,27,39,6,25,97
7269,Southwest,DFW,SEA,14,39,48,13,27,127
7270,JetBlue,ORD,BOS,17,49,23,13,3,88
7271,Southwest,JFK,SEA,21,24,13,8,3,48
7272,Southwest,LAX,SEA,21,34,56,7,17,114
7273,American,JFK,SEA,15,10,7,1,18,36
7274,Southwest,DFW,SEA,16,5,42,12,3,62
7275,American,DFW,SEA,10,19,55,14,27,115
7276,Delta,ATL,PHX,3,1,44,8,4,57
7277,American,LAX,MIA,7,5,40,0,10,55
7278,Delta,JFK,MIA,9,44,36,4,3,87
7279,JetBlue,JFK,PHX,15,7,3,4,25,39
7280,Delta,ORD,PHX,13,57,57,3,4,121
7281,United,ATL,PHX,21,56,38,4,29,127
7282,Delta,DFW,PHX,21,14,4,8,0,26
7283,Delta,ATL,PHX,19,13,40,2,12,67
7284,United,JFK,PHX,10,45,32,9,6,92
7285,Delta,ORD,MIA,23,17,22,12,2,53
7286,American,LAX,SEA,18,37,3,11,14,65
7287,Southwest,ATL,BOS,23,8,42,12,3,65
7288,United,DFW,PHX,9,5,25,9,11,50
7289,American,ATL,BOS,21,37,30,4,10,81
7290,United,ORD,BOS,22,5,42,14,0,61
7291,United,ATL,PHX,13,23,17,8,21,69
7292,American,ATL,PHX,6,29,12,11,18,70
7293,United,ORD,SEA,4,7,10,8,18,43
7294,Delta,ATL,DEN,6,24,49,1,14,88
7295,United,LAX,BOS,20,46,36,4,14,100
7296,United,JFK,DEN,2,51,56,13,20,140
7297,Delta,LAX,BOS,20,39,16,7,7,69
7298,Southwest,DFW,DEN,3,35,55,13,0,103
7299,American,LAX,MIA,15,28,53,9,17,107
7300,United,ORD,PHX,13,24,14,3,0,41
7301,JetBlue,JFK,SEA,8,13,32,0,29,74
7302,JetBlue,DFW,PHX,1,29,36,0,7,72
7303,JetBlue,ATL,DEN,4,30,42,11,29,112
7304,United,ATL,BOS,1,53,46,10,0,109
7305,JetBlue,LAX,BOS,15,41,17,11,0,69
7306,American,JFK,SEA,3,21,26,7,10,64
7307,American,ATL,MIA,15,29,38,10,15,92
7308,Southwest,LAX,DEN,2,14,18,10,27,69
7309,United,JFK,MIA,16,21,44,1,20,86
7310,United,ORD,PHX,23,50,9,11,10,80
7311,JetBlue,JFK,DEN,7,2,6,1,22,31
7312,American,ATL,MIA,12,6,27,1,24,58
7313,American,ORD,SEA,1,4,16,6,5,31
7314,Southwest,JFK,BOS,1,41,44,7,13,105
7315,JetBlue,ATL,BOS,23,13,2,11,3,29
7316,Delta,LAX,SEA,7,5,15,10,4,34
7317,Delta,DFW,MIA,15,0,13,1,23,37
7318,Delta,LAX,DEN,20,13,32,2,26,73
7319,American,ORD,SEA,9,49,49,10,16,124
7320,JetBlue,ORD,BOS,2,52,49,14,6,121
7321,Delta,ATL,DEN,7,30,45,11,26,112
7322,American,DFW,PHX,8,24,23,1,19,67
7323,JetBlue,ATL,MIA,8,33,41,10,23,107
7324,Delta,ATL,PHX,9,17,4,8,12,41
7325,United,ATL,PHX,6,4,11,9,29,53
7326,JetBlue,ATL,MIA,19,59,40,3,5,107
7327,American,ORD,BOS,23,58,2,2,6,68
7328,United,LAX,DEN,20,14,7,6,20,47
7329,JetBlue,DFW,MIA,10,3,31,6,27,67
7330,JetBlue,ORD,MIA,3,35,52,6,7,100
7331,United,LAX,DEN,18,52,6,4,29,91
7332,United,DFW,DEN,13,25,57,1,3,86
7333,Delta,DFW,BOS,5,9,56,4,16,85
7334,Southwest,JFK,BOS,1,52,12,4,4,72
7335,American,ORD,BOS,13,48,55,11,1,115
7336,Delta,ATL,DEN,11,58,13,0,13,84
7337,Delta,LAX,DEN,23,40,30,4,7,81
7338,Southwest,ATL,PHX,6,49,14,7,20,90
7339,American,JFK,PHX,18,7,57,2,15,81
7340,United,ORD,DEN,8,16,54,8,15,93
7341,Delta,JFK,BOS,22,48,26,1,3,78
7342,American,ORD,BOS,1,42,57,8,16,123
7343,Southwest,ORD,DEN,8,28,31,8,11,78
7344,Southwest,JFK,BOS,10,30,42,13,11,96
7345,JetBlue,DFW,MIA,0,43,33,11,14,101
7346,JetBlue,ORD,MIA,19,15,41,6,16,78
7347,American,DFW,MIA,16,40,28,7,16,91
7348,United,DFW,SEA,12,47,7,7,5,66
7349,Delta,ATL,BOS,8,54,39,13,28,134
7350,American,LAX,MIA,19,57,25,13,23,118
7351,United,LAX,SEA,15,39,23,12,14,88
7352,United,ATL,BOS,3,16,19,13,21,69
7353,Southwest,DFW,DEN,12,29,59,4,19,111
7354,United,ATL,PHX,14,9,11,4,19,43
7355,United,JFK,SEA,23,0,55,9,16,80
7356,Southwest,ATL,DEN,1,6,2,0,3,11
7357,Southwest,DFW,MIA,11,22,43,4,3,72
7358,United,LAX,PHX,12,28,54,1,10,93
7359,Delta,ATL,BOS,7,0,8,11,1,20
7360,American,ORD,DEN,18,40,1,14,7,62
7361,American,ATL,SEA,13,24,25,8,9,66
7362,JetBlue,LAX,MIA,23,17,6,9,9,41
7363,JetBlue,DFW,DEN,6,50,16,7,12,85
7364,Southwest,JFK,DEN,21,35,44,1,8,88
7365,Delta,JFK,PHX,4,30,29,11,25,95
7366,American,LAX,BOS,10,13,33,13,10,69
7367,Delta,ORD,MIA,5,11,4,0,28,43
7368,United,JFK,SEA,18,20,0,6,17,43
7369,JetBlue,LAX,DEN,15,32,6,6,12,56
7370,United,DFW,MIA,2,7,22,0,5,34
7371,JetBlue,ATL,DEN,21,13,2,9,16,40
7372,Delta,DFW,BOS,9,35,46,13,4,98
7373,JetBlue,ATL,SEA,22,0,51,11,11,73
7374,Delta,ATL,MIA,12,4,13,5,20,42
7375,Delta,ATL,DEN,5,1,0,0,6,7
7376,JetBlue,JFK,SEA,11,19,55,1,22,97
7377,JetBlue,JFK,SEA,14,51,35,5,4,95
7378,JetBlue,DFW,MIA,10,21,45,4,15,85
7379,Delta,JFK,MIA,14,2,4,1,12,19
7380,United,ORD,DEN,6,1,53,5,12,71
7381,United,ATL,DEN,2,48,28,9,11,96
7382,American,JFK,MIA,13,58,2,11,4,75
7383,Southwest,LAX,PHX,10,28,4,13,29,74
7384,United,DFW,BOS,19,2,1,0,9,12
7385,Delta,LAX,SEA,10,1,20,1,13,35
7386,JetBlue,DFW,MIA,20,24,29,0,8,61
7387,United,ATL,PHX,5,8,8,12,8,36
7388,Southwest,LAX,SEA,9,51,58,1,3,113
7389,Southwest,ATL,DEN,15,40,28,12,10,90
7390,JetBlue,ATL,DEN,21,17,43,9,15,84
7391,United,JFK,BOS,21,36,58,9,1,104
7392,United,JFK,PHX,3,11,41,9,12,73
7393,Delta,JFK,SEA,23,31,1,6,14,52
7394,JetBlue,ORD,BOS,15,2,58,10,11,81
7395,Southwest,ORD,SEA,10,10,47,5,17,79
7396,Southwest,JFK,SEA,1,13,19,3,27,62
7397,JetBlue,LAX,PHX,7,19,7,12,7,45
7398,JetBlue,ORD,SEA,2,20,17,5,21,63
7399,Delta,LAX,SEA,7,54,29,13,6,102
7400,Delta,ATL,SEA,14,20,32,8,11,71
7401,Southwest,LAX,BOS,23,27,1,2,24,54
7402,Delta,DFW,BOS,8,35,58,14,26,133
7403,American,LAX,MIA,1,28,0,12,27,67
7404,Southwest,JFK,PHX,7,49,51,10,5,115
7405,American,JFK,SEA,0,29,7,7,15,58
7406,JetBlue,DFW,DEN,7,43,18,7,17,85
7407,JetBlue,ATL,SEA,1,53,13,2,5,73
7408,American,LAX,DEN,10,55,52,8,9,124
7409,Delta,JFK,BOS,17,42,8,2,15,67
7410,American,ORD,BOS,12,54,39,10,25,128
7411,American,DFW,BOS,6,7,33,8,7,55
7412,Southwest,ORD,MIA,20,14,15,8,17,54
7413,JetBlue,ORD,MIA,19,49,7,10,9,75
7414,Delta,ATL,SEA,14,1,9,6,24,40
7415,United,DFW,BOS,17,49,34,1,1,85
7416,American,ATL,DEN,10,51,36,0,27,114
7417,Delta,ATL,BOS,14,52,7,4,17,80
7418,American,ATL,MIA,15,43,24,1,15,83
7419,Southwest,ATL,PHX,11,2,19,3,0,24
7420,United,JFK,PHX,4,26,59,12,18,115
7421,American,LAX,DEN,12,47,7,11,11,76
7422,Delta,LAX,PHX,22,41,29,3,3,76
7423,American,ORD,PHX,18,27,41,6,21,95
7424,Southwest,ORD,PHX,12,12,36,3,18,69
7425,Delta,DFW,BOS,7,49,50,2,23,124
7426,American,ORD,BOS,17,40,19,12,4,75
7427,United,LAX,DEN,12,15,19,7,20,61
7428,Delta,ORD,MIA,7,2,27,4,2,35
7429,JetBlue,ATL,PHX,18,47,49,1,22,119
7430,United,ORD,MIA,8,8,12,4,19,43
7431,American,ATL,MIA,16,14,14,5,10,43
7432,American,LAX,BOS,23,49,7,14,21,91
7433,United,ORD,BOS,6,37,59,1,6,103
7434,Southwest,ATL,PHX,0,38,46,7,20,111
7435,American,ATL,SEA,2,54,0,7,20,81
7436,United,ORD,DEN,9,28,36,2,19,85
7437,JetBlue,JFK,PHX,12,14,12,7,11,44
7438,United,LAX,MIA,3,0,44,14,13,71
7439,American,ORD,MIA,20,7,55,10,23,95
7440,United,JFK,BOS,14,2,16,8,27,53
7441,Southwest,ORD,DEN,20,37,43,14,13,107
7442,Southwest,JFK,DEN,3,20,5,8,27,60
7443,JetBlue,LAX,DEN,9,36,1,14,16,67
7444,United,JFK,SEA,11,24,11,13,3,51
7445,Delta,DFW,MIA,19,27,2,1,22,52
7446,American,ATL,DEN,5,33,22,12,15,82
7447,American,ORD,MIA,13,44,35,2,15,96
7448,Southwest,JFK,BOS,22,25,30,12,29,96
7449,American,ATL,SEA,19,44,20,7,15,86
7450,American,DFW,BOS,7,13,52,14,16,95
7451,American,ATL,BOS,16,22,12,3,8,45
7452,Delta,ATL,DEN,8,17,26,2,20,65
7453,American,ORD,DEN,22,18,30,1,1,50
7454,American,ORD,PHX,2,30,59,7,19,115
7455,Delta,ATL,DEN,13,52,14,10,26,102
7456,United,LAX,DEN,9,14,39,7,19,79
7457,American,LAX,MIA,10,13,14,2,26,55
7458,Delta,LAX,MIA,9,51,13,6,3,73
7459,American,JFK,BOS,2,47,27,14,16,104
7460,American,ORD,DEN,2,20,43,1,23,87
7461,United,LAX,BOS,14,31,48,10,5,94
7462,JetBlue,DFW,PHX,18,28,22,1,23,74
7463,Southwest,ORD,PHX,18,3,54,9,9,75
7464,JetBlue,ATL,BOS,21,51,3,11,20,85
7465,JetBlue,LAX,BOS,4,23,48,11,18,100
7466,American,JFK,MIA,14,7,9,8,27,51
7467,Delta,ATL,SEA,1,54,12,4,2,72
7468,Southwest,ORD,BOS,3,31,36,13,1,81
7469,United,JFK,MIA,3,26,0,5,14,45
7470,Delta,LAX,SEA,19,1,52,7,6,66
7471,JetBlue,ORD,MIA,23,24,42,8,18,92
7472,Southwest,DFW,BOS,0,36,47,5,12,100
7473,JetBlue,ATL,SEA,11,22,18,7,1,48
7474,United,ATL,SEA,10,55,18,6,6,85
7475,Delta,DFW,MIA,17,50,53,4,3,110
7476,United,ORD,PHX,22,31,9,4,8,52
7477,American,DFW,DEN,22,31,24,2,6,63
7478,United,DFW,SEA,21,39,23,5,28,95
7479,American,JFK,BOS,7,58,59,10,15,142
7480,Southwest,JFK,DEN,14,36,5,2,23,66
7481,Delta,ORD,MIA,23,38,59,3,12,112
7482,Delta,ATL,PHX,9,33,30,4,14,81
7483,JetBlue,LAX,MIA,8,20,22,14,29,85
7484,United,LAX,SEA,9,49,9,10,12,80
7485,JetBlue,ATL,MIA,15,9,4,14,4,31
7486,Delta,DFW,PHX,22,57,15,13,15,100
7487,JetBlue,ORD,PHX,19,57,54,13,27,151
7488,United,LAX,DEN,8,50,43,13,27,133
7489,JetBlue,ORD,MIA,8,5,15,0,21,41
7490,Delta,DFW,SEA,5,19,8,11,26,64
7491,JetBlue,ATL,MIA,1,13,40,13,13,79
7492,American,LAX,MIA,15,34,40,7,2,83
7493,Southwest,ATL,BOS,0,12,10,14,19,55
7494,JetBlue,DFW,MIA,13,4,24,2,27,57
7495,Delta,LAX,MIA,8,38,1,12,3,54
7496,United,JFK,PHX,1,50,11,3,13,77
7497,American,ORD,BOS,17,34,4,3,28,69
7498,United,DFW,BOS,18,0,50,8,6,64
7499,United,ORD,PHX,6,49,39,6,6,100
7500,United,ORD,SEA,5,18,8,6,0,32
7501,Southwest,ORD,MIA,20,51,49,9,16,125
7502,American,DFW,MIA,13,23,12,6,23,64
7503,Delta,ORD,MIA,16,12,26,0,7,45
7504,Delta,DFW,PHX,7,44,58,11,11,124
7505,JetBlue,ATL,PHX,8,51,42,12,11,116
7506,United,ATL,DEN,4,36,48,1,5,90
7507,United,DFW,BOS,3,55,30,10,29,124
7508,United,DFW,SEA,9,54,41,10,19,124
7509,Southwest,LAX,PHX,11,41,24,0,15,80
7510,Southwest,JFK,PHX,18,19,54,12,28,113
7511,United,ORD,PHX,16,7,19,11,2,39
7512,Delta,LAX,MIA,12,51,39,10,18,118
7513,Southwest,ATL,DEN,7,5,21,1,18,45
7514,United,JFK,MIA,1,46,28,7,9,90
7515,Delta,JFK,PHX,23,34,42,7,16,99
7516,American,DFW,DEN,6,29,42,3,20,94
7517,JetBlue,ATL,PHX,3,50,0,12,23,85
7518,Southwest,JFK,MIA,20,4,13,12,20,49
7519,Southwest,DFW,PHX,2,8,36,1,22,67
7520,American,JFK,SEA,6,36,7,2,19,64
7521,Southwest,DFW,MIA,10,42,15,13,6,76
7522,Delta,ATL,MIA,13,2,49,9,27,87
7523,American,LAX,BOS,5,32,35,8,17,92
7524,JetBlue,ATL,SEA,9,37,39,4,20,100
7525,American,DFW,MIA,6,11,44,2,21,78
7526,American,DFW,SEA,1,43,13,9,18,83
7527,Delta,DFW,PHX,6,43,50,10,5,108
7528,American,LAX,DEN,16,47,24,4,7,82
7529,Delta,JFK,SEA,19,9,53,3,10,75
7530,United,DFW,SEA,23,17,4,1,1,23
7531,American,ORD,BOS,16,9,47,2,24,82
7532,Delta,LAX,DEN,12,21,7,0,13,41
7533,Southwest,JFK,BOS,16,12,10,7,28,57
7534,Southwest,ATL,PHX,11,3,47,7,8,65
7535,Southwest,LAX,BOS,22,8,53,6,28,95
7536,American,JFK,BOS,17,52,39,1,8,100
7537,Southwest,LAX,MIA,10,45,42,4,21,112
7538,JetBlue,DFW,BOS,9,18,19,10,17,64
7539,Southwest,JFK,MIA,1,9,25,12,5,51
7540,United,ORD,PHX,21,53,56,1,18,128
7541,Southwest,ATL,DEN,14,34,24,12,22,92
7542,Southwest,DFW,BOS,11,58,57,4,28,147
7543,Southwest,DFW,PHX,12,43,15,13,14,85
7544,United,ATL,MIA,2,0,56,0,14,70
7545,Southwest,ORD,PHX,15,23,1,6,26,56
7546,Delta,LAX,DEN,1,50,36,0,29,115
7547,Southwest,JFK,SEA,14,14,32,1,17,64
7548,United,ORD,MIA,8,39,39,4,19,101
7549,Delta,ATL,DEN,6,53,24,7,25,109
7550,Delta,ATL,DEN,15,19,40,6,8,73
7551,JetBlue,ORD,DEN,21,15,28,0,15,58
7552,Delta,JFK,PHX,15,30,55,12,4,101
7553,JetBlue,LAX,BOS,22,24,31,13,17,85
7554,American,LAX,PHX,20,15,43,12,22,92
7555,Delta,ATL,DEN,4,59,7,3,14,83
7556,United,ATL,PHX,13,56,2,13,27,98
7557,American,LAX,DEN,19,4,50,4,24,82
7558,Southwest,ATL,BOS,2,41,30,7,2,80
7559,Delta,ATL,PHX,4,4,6,9,27,46
7560,Southwest,DFW,BOS,7,37,22,2,1,62
7561,United,JFK,PHX,4,49,24,11,8,92
7562,United,ORD,DEN,21,24,39,5,4,72
7563,Delta,ATL,BOS,10,16,56,7,26,105
7564,Southwest,ORD,SEA,13,33,30,6,24,93
7565,Delta,JFK,BOS,21,10,33,14,17,74
7566,Southwest,LAX,SEA,2,36,55,2,20,113
7567,Delta,ATL,DEN,10,59,35,1,11,106
7568,JetBlue,LAX,BOS,9,22,36,5,17,80
7569,Delta,ATL,DEN,6,22,43,5,27,97
7570,American,ORD,DEN,23,37,6,13,28,84
7571,Southwest,LAX,BOS,5,46,6,4,16,72
7572,Southwest,LAX,SEA,13,45,2,2,22,71
7573,Southwest,JFK,BOS,2,26,0,6,20,52
7574,American,ATL,MIA,23,3,42,2,21,68
7575,American,ORD,MIA,7,3,20,12,1,36
7576,Delta,ORD,PHX,15,50,30,3,9,92
7577,United,ORD,PHX,11,44,49,7,17,117
7578,American,ATL,DEN,13,26,1,4,15,46
7579,Southwest,LAX,DEN,18,35,42,7,15,99
7580,Delta,JFK,MIA,12,16,37,4,24,81
7581,JetBlue,DFW,DEN,3,28,15,2,25,70
7582,Southwest,DFW,MIA,21,47,23,13,4,87
7583,American,DFW,PHX,13,50,1,9,2,62
7584,United,JFK,PHX,12,10,44,2,25,81
7585,United,DFW,DEN,14,25,38,2,9,74
7586,Southwest,DFW,MIA,10,18,41,1,11,71
7587,American,ORD,BOS,21,58,42,14,4,118
7588,United,LAX,BOS,5,38,8,14,8,68
7589,JetBlue,ORD,BOS,21,33,29,10,16,88
7590,Southwest,DFW,DEN,13,15,2,12,15,44
7591,United,JFK,DEN,17,16,50,13,8,87
7592,JetBlue,LAX,SEA,19,39,28,5,3,75
7593,Southwest,LAX,BOS,7,54,51,14,28,147
7594,JetBlue,LAX,PHX,13,25,38,10,1,74
7595,JetBlue,DFW,BOS,15,21,41,13,14,89
7596,United,DFW,BOS,8,36,35,3,14,88
7597,Southwest,DFW,PHX,13,4,29,9,3,45
7598,American,ATL,DEN,17,21,18,0,2,41
7599,Delta,LAX,MIA,17,5,22,7,11,45
7600,Southwest,JFK,DEN,9,32,51,8,28,119
7601,Delta,ATL,DEN,16,2,50,13,18,83
7602,Delta,JFK,BOS,23,14,28,1,0,43
7603,Delta,ATL,DEN,5,53,5,0,7,65
7604,Southwest,LAX,BOS,17,55,31,12,9,107
7605,American,ATL,DEN,2,14,3,12,25,54
7606,JetBlue,LAX,MIA,14,13,18,14,2,47
7607,United,LAX,BOS,21,8,43,12,26,89
7608,United,ORD,MIA,19,19,28,9,28,84
7609,Delta,LAX,SEA,18,27,35,9,29,100
7610,JetBlue,JFK,BOS,4,43,16,9,4,72
7611,Delta,JFK,MIA,19,41,10,1,20,72
7612,Delta,LAX,SEA,12,0,25,3,10,38
7613,United,JFK,SEA,21,51,16,3,5,75
7614,American,DFW,PHX,4,34,59,9,4,106
7615,United,ATL,DEN,8,2,31,9,22,64
7616,Delta,LAX,DEN,10,44,45,3,2,94
7617,Southwest,JFK,PHX,16,34,25,13,9,81
7618,JetBlue,JFK,BOS,15,11,59,0,3,73
7619,JetBlue,ATL,MIA,0,30,8,14,28,80
7620,American,DFW,SEA,23,24,45,3,25,97
7621,JetBlue,ORD,PHX,21,54,55,14,29,152
7622,United,JFK,DEN,5,26,33,10,12,81
7623,United,JFK,MIA,0,47,15,1,18,81
7624,American,ATL,PHX,9,8,4,0,25,37
7625,Southwest,ATL,PHX,22,38,39,12,22,111
7626,American,DFW,PHX,9,3,4,14,23,44
7627,Delta,LAX,BOS,21,44,13,7,2,66
7628,American,LAX,DEN,9,33,33,7,22,95
7629,JetBlue,JFK,MIA,1,59,40,2,27,128
7630,United,ORD,BOS,1,34,3,6,13,56
7631,American,ORD,MIA,3,59,56,1,15,131
7632,Southwest,ORD,MIA,22,44,37,2,29,112
7633,United,DFW,BOS,3,7,25,2,17,51
7634,Delta,ORD,BOS,21,10,42,5,1,58
7635,United,ATL,SEA,13,49,33,4,12,98
7636,American,DFW,MIA,22,41,42,10,20,113
7637,American,ATL,SEA,14,57,2,14,6,79
7638,American,ATL,BOS,22,47,22,14,12,95
7639,American,ATL,BOS,4,33,39,10,3,85
7640,Southwest,ATL,BOS,14,52,23,3,29,107
7641,JetBlue,LAX,PHX,9,55,55,0,13,123
7642,JetBlue,LAX,DEN,14,47,7,10,1,65
7643,JetBlue,LAX,MIA,13,8,55,12,13,88
7644,JetBlue,LAX,MIA,8,26,21,1,15,63
7645,Southwest,ORD,BOS,20,26,32,4,14,76
7646,Delta,ATL,BOS,4,51,50,12,21,134
7647,Southwest,DFW,PHX,10,21,32,7,9,69
7648,JetBlue,DFW,DEN,19,42,8,11,9,70
7649,Delta,DFW,BOS,1,35,5,14,20,74
7650,JetBlue,JFK,PHX,19,39,24,13,19,95
7651,Southwest,ORD,DEN,4,56,33,1,0,90
7652,Delta,ORD,PHX,4,30,53,8,27,118
7653,United,LAX,BOS,14,26,28,2,14,70
7654,United,DFW,BOS,7,20,43,3,18,84
7655,JetBlue,ATL,SEA,4,6,19,11,15,51
7656,American,JFK,SEA,20,33,32,1,14,80
7657,JetBlue,ORD,MIA,8,2,1,8,29,40
7658,American,LAX,PHX,18,20,24,0,0,44
7659,American,DFW,BOS,17,50,37,6,12,105
7660,JetBlue,JFK,MIA,6,16,8,14,27,65
7661,JetBlue,ORD,PHX,1,26,31,12,16,85
7662,Southwest,ORD,MIA,7,13,45,10,3,71
7663,United,JFK,PHX,16,29,33,10,6,78
7664,Delta,ATL,SEA,12,31,48,2,20,101
7665,Southwest,LAX,DEN,17,7,15,2,5,29
7666,Southwest,LAX,MIA,11,40,0,8,11,59
7667,American,ATL,BOS,8,59,9,10,22,100
7668,United,ATL,DEN,19,35,8,9,5,57
7669,Southwest,ORD,MIA,21,25,14,13,11,63
7670,American,ATL,MIA,6,28,54,12,5,99
7671,Delta,LAX,DEN,9,32,52,0,24,108
7672,Southwest,LAX,BOS,11,42,4,11,24,81
7673,United,DFW,MIA,8,18,55,0,26,99
7674,JetBlue,LAX,MIA,10,24,44,12,21,101
7675,American,ATL,MIA,11,48,37,7,26,118
7676,United,LAX,DEN,18,4,48,0,9,61
7677,American,ATL,BOS,20,24,15,6,8,53
7678,Delta,ATL,DEN,0,8,16,12,8,44
7679,Southwest,DFW,SEA,3,48,50,12,10,120
7680,JetBlue,DFW,PHX,11,44,29,13,1,87
7681,United,ORD,DEN,12,3,35,0,10,48
7682,United,LAX,SEA,7,59,20,7,26,112
7683,American,ATL,BOS,16,27,2,5,17,51
7684,American,ORD,SEA,5,33,20,9,9,71
7685,American,ATL,MIA,10,28,25,2,19,74
7686,Delta,LAX,MIA,2,19,30,8,25,82
7687,Southwest,JFK,PHX,9,10,9,3,25,47
7688,JetBlue,ORD,DEN,15,18,41,11,2,72
7689,JetBlue,LAX,SEA,6,50,44,1,27,122
7690,Delta,LAX,PHX,16,54,18,10,26,108
7691,Southwest,JFK,PHX,23,15,53,10,21,99
7692,Southwest,JFK,BOS,2,23,59,12,2,96
7693,American,JFK,MIA,12,41,54,6,10,111
7694,Southwest,LAX,SEA,0,32,34,5,22,93
7695,United,ORD,BOS,2,36,29,11,19,95
7696,Southwest,ATL,DEN,0,50,8,11,1,70
7697,Delta,ATL,SEA,12,13,8,5,18,44
7698,United,DFW,SEA,5,51,7,13,23,94
7699,JetBlue,DFW,SEA,23,15,7,6,19,47
7700,Southwest,DFW,PHX,19,2,31,10,10,53
7701,United,ATL,SEA,7,31,18,5,14,68
7702,Delta,ATL,PHX,16,30,56,8,20,114
7703,Delta,ORD,DEN,11,10,31,8,20,69
7704,Southwest,DFW,MIA,2,21,14,10,26,71
7705,Delta,DFW,BOS,15,9,27,3,13,52
7706,JetBlue,JFK,PHX,7,17,13,8,29,67
7707,American,ORD,SEA,9,26,0,8,16,50
7708,JetBlue,DFW,BOS,7,38,18,10,25,91
7709,United,DFW,SEA,5,28,52,8,7,95
7710,JetBlue,DFW,MIA,15,14,16,10,11,51
7711,Delta,JFK,MIA,21,0,39,4,0,43
7712,United,ATL,SEA,15,21,10,1,3,35
7713,Delta,ATL,SEA,6,32,6,14,27,79
7714,Delta,ORD,PHX,20,26,27,12,26,91
7715,American,LAX,PHX,2,39,26,0,11,76
7716,United,ORD,BOS,16,15,5,0,26,46
7717,Southwest,LAX,DEN,12,47,22,5,7,81
7718,Delta,LAX,SEA,19,57,57,9,14,137
7719,United,ATL,MIA,18,22,52,10,16,100
7720,United,DFW,BOS,8,17,56,5,23,101
7721,Southwest,ORD,MIA,0,39,50,8,1,98
7722,Delta,ATL,BOS,1,41,39,11,9,100
7723,American,ORD,SEA,5,20,2,2,10,34
7724,United,JFK,BOS,23,24,38,6,20,88
7725,JetBlue,ATL,MIA,17,46,48,2,17,113
7726,Southwest,DFW,PHX,18,30,45,0,11,86
7727,Southwest,ORD,SEA,5,35,41,14,19,109
7728,Delta,DFW,DEN,22,4,55,12,4,75
7729,Southwest,JFK,SEA,1,27,17,11,27,82
7730,JetBlue,ORD,BOS,9,19,31,4,7,61
7731,JetBlue,ATL,SEA,18,26,33,5,12,76
7732,American,DFW,SEA,16,51,57,7,2,117
7733,Southwest,LAX,SEA,4,10,14,6,11,41
7734,United,JFK,MIA,8,56,17,9,24,106
7735,American,LAX,BOS,6,49,56,1,0,106
7736,Delta,LAX,PHX,21,2,51,1,21,75
7737,United,DFW,BOS,2,35,19,13,23,90
7738,United,LAX,BOS,23,27,41,11,15,94
7739,JetBlue,DFW,SEA,3,24,6,1,14,45
7740,Southwest,LAX,BOS,15,32,18,0,27,77
7741,Delta,LAX,PHX,14,27,42,14,10,93
7742,United,JFK,BOS,13,0,25,2,2,29
7743,JetBlue,JFK,SEA,16,47,37,8,5,97
7744,Delta,ORD,MIA,3,8,29,1,6,44
7745,United,ATL,PHX,3,18,55,12,17,102
7746,United,ATL,DEN,8,30,43,12,24,109
7747,United,LAX,MIA,4,16,0,5,17,38
7748,United,ORD,PHX,20,12,40,10,14,76
7749,Delta,JFK,MIA,16,16,41,8,6,71
7750,Southwest,ORD,DEN,7,26,5,14,3,48
7751,American,ORD,DEN,19,59,47,5,18,129
7752,Southwest,LAX,SEA,5,34,30,4,6,74
7753,Delta,ORD,PHX,22,36,21,0,0,57
7754,American,JFK,DEN,0,9,50,2,2,63
7755,United,JFK,BOS,15,2,31,1,17,51
7756,American,DFW,BOS,1,28,28,3,15,74
7757,American,ATL,MIA,4,18,41,9,3,71
7758,JetBlue,ATL,SEA,19,38,30,4,28,100
7759,Southwest,ORD,PHX,20,13,44,1,0,58
7760,American,LAX,BOS,15,41,0,6,5,52
7761,JetBlue,DFW,MIA,23,25,52,6,10,93
7762,Delta,JFK,PHX,3,2,14,8,17,41
7763,American,ORD,SEA,20,11,14,7,17,49
7764,American,JFK,BOS,22,12,40,3,15,70
7765,American,LAX,MIA,12,12,11,3,21,47
7766,United,DFW,SEA,6,53,3,4,4,64
7767,Southwest,DFW,PHX,15,55,38,3,15,111
7768,American,JFK,SEA,4,45,41,9,6,101
7769,JetBlue,LAX,BOS,12,6,25,2,5,38
7770,Delta,JFK,BOS,12,41,28,1,18,88
7771,Delta,JFK,PHX,7,23,6,13,16,58
7772,American,ORD,DEN,5,8,16,13,2,39
7773,JetBlue,DFW,DEN,20,45,14,14,11,84
7774,American,ORD,PHX,0,47,55,14,8,124
7775,Southwest,ATL,MIA,16,39,41,8,7,95
7776,Southwest,DFW,PHX,17,52,11,14,17,94
7777,American,ORD,BOS,22,37,49,12,12,110
7778,American,JFK,MIA,21,0,18,11,4,33
7779,Southwest,ATL,SEA,4,48,42,12,12,114
7780,American,DFW,DEN,1,7,21,13,6,47
7781,American,ORD,DEN,12,18,56,7,8,89
7782,Delta,ORD,PHX,9,42,23,1,18,84
7783,Delta,LAX,MIA,18,19,49,1,27,96
7784,JetBlue,ORD,BOS,6,25,32,7,15,79
7785,Delta,ATL,MIA,21,6,55,14,6,81
7786,JetBlue,ORD,MIA,23,54,37,8,12,111
7787,United,DFW,DEN,10,19,24,12,13,68
7788,Southwest,ATL,DEN,6,31,56,8,3,98
7789,American,ATL,DEN,0,51,31,4,4,90
7790,American,LAX,MIA,22,55,0,13,0,68
7791,Delta,JFK,MIA,6,13,13,5,25,56
7792,Delta,JFK,SEA,1,1,44,13,7,65
7793,JetBlue,JFK,SEA,23,12,38,5,27,82
7794,Delta,LAX,DEN,6,22,10,11,29,72
7795,JetBlue,ORD,MIA,11,41,34,0,16,91
7796,American,ATL,MIA,17,39,31,5,9,84
7797,Delta,ATL,BOS,18,56,30,11,4,101
7798,JetBlue,LAX,PHX,8,8,38,14,25,85
7799,United,JFK,BOS,8,16,57,13,24,110
7800,JetBlue,ORD,BOS,3,5,13,8,8,34
7801,American,ORD,DEN,12,20,43,6,1,70
7802,JetBlue,DFW,DEN,6,11,33,6,10,60
7803,Delta,ORD,BOS,9,20,3,8,10,41
7804,United,JFK,DEN,4,41,16,5,25,87
7805,United,ORD,BOS,10,17,54,9,3,83
7806,United,ORD,MIA,16,12,57,4,12,85
7807,American,DFW,PHX,23,1,43,5,12,61
7808,Delta,JFK,PHX,14,35,36,8,24,103
7809,JetBlue,ATL,BOS,3,51,41,13,23,128
7810,JetBlue,ATL,MIA,12,56,17,0,7,80
7811,United,LAX,SEA,9,50,46,2,19,117
7812,American,ATL,PHX,20,33,32,0,5,70
7813,United,ORD,MIA,8,21,3,9,0,33
7814,JetBlue,DFW,BOS,0,39,56,9,2,106
7815,Southwest,DFW,SEA,5,30,44,8,16,98
7816,United,ATL,SEA,13,9,4,11,4,28
7817,American,LAX,BOS,14,48,36,1,29,114
7818,Delta,LAX,MIA,2,33,44,11,18,106
7819,Delta,LAX,MIA,17,41,20,6,27,94
7820,Delta,ORD,DEN,1,52,34,2,16,104
7821,American,DFW,SEA,18,5,54,10,17,86
7822,United,ATL,DEN,8,54,25,8,7,94
7823,United,ORD,PHX,17,45,35,4,23,107
7824,United,DFW,DEN,20,45,0,10,4,59
7825,American,ATL,DEN,18,41,20,3,19,83
7826,Delta,DFW,SEA,4,40,38,3,20,101
7827,Delta,ORD,MIA,11,7,10,8,10,35
7828,Delta,ATL,BOS,18,59,31,13,14,117
7829,American,DFW,PHX,10,14,46,7,17,84
7830,JetBlue,DFW,PHX,22,54,1,12,6,73
7831,United,DFW,SEA,15,23,18,3,13,57
7832,Delta,JFK,PHX,23,27,56,1,25,109
7833,United,ORD,BOS,6,9,16,10,18,53
7834,United,ORD,SEA,14,8,7,14,25,54
7835,American,ORD,BOS,11,53,57,3,1,114
7836,American,ATL,MIA,2,1,39,6,5,51
7837,Delta,ATL,PHX,17,17,8,11,16,52
7838,JetBlue,ATL,BOS,5,47,23,3,26,99
7839,American,ATL,PHX,8,44,0,5,12,61
7840,Southwest,LAX,SEA,23,15,35,2,19,71
7841,American,JFK,BOS,12,4,26,5,27,62
7842,American,LAX,DEN,21,49,45,12,24,130
7843,JetBlue,DFW,PHX,20,18,20,12,18,68
7844,American,LAX,PHX,16,21,37,1,18,77
7845,American,ORD,PHX,12,52,12,14,20,98
7846,Southwest,JFK,PHX,3,38,45,11,10,104
7847,Delta,LAX,MIA,0,42,0,9,13,64
7848,JetBlue,ATL,PHX,3,44,37,7,8,96
7849,American,LAX,BOS,23,43,20,1,25,89
7850,Southwest,ATL,PHX,9,43,8,3,7,61
7851,JetBlue,LAX,DEN,2,22,15,4,7,48
7852,American,ATL,BOS,2,25,50,4,27,106
7853,United,DFW,SEA,2,56,16,12,27,111
7854,JetBlue,ORD,MIA,22,8,10,11,27,56
7855,United,LAX,DEN,23,48,59,10,19,136
7856,JetBlue,DFW,SEA,22,54,38,14,7,113
7857,American,LAX,PHX,12,33,10,2,16,61
7858,American,DFW,DEN,2,56,2,7,2,67
7859,JetBlue,LAX,DEN,0,44,38,7,11,100
7860,Southwest,DFW,MIA,6,23,30,5,21,79
7861,United,JFK,PHX,18,25,14,3,15,57
7862,United,DFW,BOS,21,48,3,10,14,75
7863,Delta,JFK,DEN,6,16,35,4,9,64
7864,JetBlue,ORD,SEA,3,6,56,12,25,99
7865,United,LAX,MIA,8,57,45,10,5,117
7866,American,JFK,BOS,8,50,1,1,12,64
7867,United,ATL,PHX,19,34,57,1,24,116
7868,United,DFW,PHX,7,56,17,2,10,85
7869,JetBlue,LAX,PHX,8,47,10,6,23,86
7870,United,LAX,PHX,6,28,23,4,3,58
7871,American,ORD,PHX,21,50,43,1,14,108
7872,Southwest,LAX,SEA,22,7,40,6,27,80
7873,Southwest,ORD,BOS,22,36,0,10,17,63
7874,United,JFK,PHX,19,1,12,4,3,20
7875,American,ATL,SEA,3,36,11,13,12,72
7876,United,DFW,BOS,3,37,3,13,14,67
7877,American,ATL,PHX,21,56,18,8,29,111
7878,United,ORD,PHX,17,14,43,9,8,74
7879,American,JFK,BOS,4,41,51,5,19,116
7880,Delta,ATL,MIA,1,49,19,2,0,70
7881,United,LAX,PHX,0,39,6,4,6,55
7882,Southwest,ORD,DEN,6,15,33,10,1,59
7883,American,LAX,DEN,13,44,59,7,7,117
7884,Delta,DFW,DEN,20,37,9,3,12,61
7885,Delta,ORD,MIA,22,48,59,7,6,120
7886,Southwest,DFW,BOS,9,14,46,5,8,73
7887,United,DFW,DEN,17,27,22,5,3,57
7888,Southwest,DFW,MIA,3,2,35,2,20,59
7889,JetBlue,JFK,MIA,22,0,38,8,12,58
7890,American,ORD,PHX,19,43,22,12,18,95
7891,Delta,DFW,SEA,3,51,56,2,26,135
7892,United,ATL,BOS,9,13,20,7,26,66
7893,JetBlue,LAX,DEN,8,40,56,12,9,117
7894,United,JFK,SEA,13,53,12,14,22,101
7895,American,ORD,BOS,19,43,23,2,26,94
7896,Delta,ORD,PHX,17,55,19,9,18,101
7897,United,ATL,BOS,12,35,52,6,14,107
7898,JetBlue,JFK,PHX,18,4,13,1,6,24
7899,American,DFW,SEA,14,14,57,3,1,75
7900,Southwest,LAX,PHX,21,6,25,3,9,43
7901,American,JFK,BOS,9,17,25,2,20,64
7902,Southwest,ATL,BOS,0,15,27,0,19,61
7903,United,DFW,SEA,14,45,28,0,14,87
7904,JetBlue,LAX,DEN,8,14,13,1,21,49
7905,JetBlue,ORD,SEA,13,45,0,13,25,83
7906,JetBlue,JFK,BOS,18,17,33,14,26,90
7907,Southwest,ORD,DEN,6,4,55,13,19,91
7908,United,JFK,DEN,4,36,32,7,8,83
7909,Southwest,ORD,DEN,7,24,14,4,16,58
7910,Southwest,JFK,PHX,11,16,22,7,14,59
7911,Delta,JFK,BOS,4,27,54,14,18,113
7912,United,ATL,DEN,12,10,48,8,4,70
7913,United,DFW,PHX,5,51,52,3,1,107
7914,Delta,DFW,SEA,11,11,23,11,22,67
7915,American,JFK,PHX,10,3,57,0,0,60
7916,JetBlue,ATL,SEA,6,59,5,14,20,98
7917,American,ATL,MIA,8,6,57,11,4,78
7918,Delta,JFK,BOS,12,50,21,5,29,105
7919,JetBlue,JFK,SEA,3,55,14,6,9,84
7920,Southwest,LAX,PHX,0,49,59,3,0,111
7921,JetBlue,ORD,MIA,14,26,23,11,28,88
7922,United,DFW,DEN,23,53,7,4,20,84
7923,Delta,JFK,PHX,9,49,52,4,17,122
7924,Southwest,ATL,MIA,10,10,7,12,7,36
7925,JetBlue,ORD,MIA,5,56,16,9,15,96
7926,American,DFW,PHX,7,40,16,5,3,64
7927,United,LAX,MIA,7,6,9,7,7,29
7928,Delta,ORD,DEN,7,57,49,11,6,123
7929,Delta,ORD,DEN,15,38,6,10,1,55
7930,Delta,ATL,DEN,10,21,39,3,23,86
7931,Southwest,LAX,BOS,9,10,26,2,8,46
7932,United,JFK,PHX,12,32,9,14,2,57
7933,JetBlue,ORD,DEN,16,51,11,1,16,79
7934,Southwest,ATL,SEA,20,51,17,11,14,93
7935,United,LAX,PHX,12,14,35,6,15,70
7936,American,DFW,DEN,20,56,54,7,18,135
7937,Delta,DFW,SEA,17,48,26,0,20,94
7938,United,JFK,PHX,22,14,51,11,3,79
7939,United,ATL,DEN,1,34,52,3,12,101
7940,Delta,ATL,BOS,0,40,51,11,29,131
7941,Southwest,DFW,SEA,7,1,8,5,14,28
7942,United,ATL,DEN,9,55,51,1,23,130
7943,JetBlue,DFW,SEA,17,20,50,6,4,80
7944,Southwest,LAX,BOS,10,42,34,8,9,93
7945,JetBlue,ATL,SEA,20,55,33,3,18,109
7946,Southwest,DFW,SEA,3,27,33,8,1,69
7947,United,ORD,DEN,6,45,46,7,16,114
7948,Delta,ATL,DEN,9,40,39,8,6,93
7949,JetBlue,ORD,DEN,14,36,17,2,13,68
7950,Delta,LAX,BOS,23,47,34,12,28,121
7951,American,ATL,BOS,19,48,14,8,17,87
7952,Southwest,LAX,PHX,6,5,55,2,26,88
7953,Delta,LAX,BOS,2,13,58,7,25,103
7954,Delta,ATL,DEN,8,5,12,3,5,25
7955,Delta,ORD,SEA,4,41,12,8,27,88
7956,American,ORD,MIA,5,59,39,9,23,130
7957,JetBlue,JFK,DEN,15,5,40,3,4,52
7958,Southwest,ORD,MIA,15,57,15,13,10,95
7959,American,ORD,SEA,17,17,1,8,14,40
7960,United,LAX,DEN,7,48,33,14,26,121
7961,Delta,LAX,BOS,17,54,40,12,25,131
7962,Southwest,LAX,BOS,23,53,51,0,8,112
7963,American,LAX,SEA,3,28,41,5,2,76
7964,Southwest,ATL,DEN,22,14,54,6,7,81
7965,United,ATL,SEA,16,2,11,7,26,46
7966,JetBlue,ORD,BOS,3,9,11,11,0,31
7967,United,ORD,BOS,13,9,50,12,29,100
7968,United,JFK,PHX,2,4,34,8,5,51
7969,JetBlue,LAX,SEA,16,21,6,9,29,65
7970,American,ATL,PHX,12,11,22,4,21,58
7971,JetBlue,DFW,SEA,9,37,23,0,26,86
7972,Southwest,DFW,SEA,0,38,59,0,19,116
7973,Southwest,ATL,BOS,15,34,4,11,8,57
7974,Delta,ATL,SEA,13,3,4,13,26,46
7975,JetBlue,JFK,BOS,23,33,47,0,20,100
7976,Delta,ORD,SEA,11,51,13,11,20,95
7977,United,ATL,DEN,11,7,30,13,18,68
7978,JetBlue,LAX,DEN,20,5,47,3,11,66
7979,American,ORD,BOS,3,10,26,1,10,47
7980,Southwest,ORD,DEN,6,20,18,5,25,68
7981,Southwest,DFW,DEN,12,51,32,9,29,121
7982,JetBlue,LAX,DEN,19,23,57,10,27,117
7983,Delta,DFW,PHX,0,45,48,14,8,115
7984,American,ORD,PHX,14,40,5,5,25,75
7985,United,JFK,DEN,17,49,55,13,1,118
7986,United,JFK,BOS,19,39,44,6,17,106
7987,United,JFK,PHX,3,26,59,9,6,100
7988,American,LAX,SEA,19,36,44,8,25,113
7989,Southwest,JFK,DEN,19,7,15,9,28,59
7990,United,DFW,MIA,7,28,55,5,8,96
7991,American,JFK,MIA,10,46,58,9,27,140
7992,Delta,ATL,BOS,8,7,8,0,29,44
7993,Delta,LAX,BOS,13,5,50,4,19,78
7994,American,ATL,DEN,12,58,27,0,8,93
7995,United,ATL,PHX,4,48,9,0,5,62
7996,Southwest,DFW,PHX,10,38,45,6,26,115
7997,American,LAX,BOS,9,29,14,10,14,67
7998,Delta,ATL,SEA,11,42,34,13,28,117
7999,JetBlue,JFK,DEN,15,3,35,5,23,66
8000,United,JFK,DEN,2,4,48,1,20,73
8001,American,JFK,DEN,4,24,44,10,12,90
8002,Delta,ATL,SEA,4,43,25,4,23,95
8003,American,ORD,PHX,6,49,48,12,24,133
8004,Southwest,DFW,BOS,20,15,13,2,6,36
8005,JetBlue,ORD,BOS,3,51,55,6,0,112
8006,American,ORD,SEA,20,10,38,4,11,63
8007,United,JFK,DEN,18,20,25,13,7,65
8008,JetBlue,DFW,PHX,4,27,7,1,8,43
8009,Southwest,ATL,BOS,16,57,36,2,27,122
8010,JetBlue,LAX,DEN,5,16,49,10,8,83
8011,Delta,LAX,BOS,14,26,41,2,24,93
8012,United,JFK,MIA,12,15,20,11,19,65
8013,Delta,LAX,DEN,5,34,4,4,15,57
8014,American,DFW,DEN,19,54,58,1,5,118
8015,American,JFK,MIA,21,40,27,10,11,88
8016,American,ATL,PHX,5,14,7,2,22,45
8017,United,JFK,BOS,11,24,8,6,10,48
8018,Southwest,LAX,BOS,2,40,26,2,29,97
8019,Delta,DFW,SEA,15,29,12,11,7,59
8020,JetBlue,DFW,PHX,16,50,36,13,9,108
8021,JetBlue,JFK,BOS,9,43,48,14,22,127
8022,Southwest,ATL,MIA,3,42,0,12,6,60
8023,Delta,LAX,PHX,23,13,57,0,9,79
8024,JetBlue,ORD,BOS,12,33,35,3,1,72
8025,American,LAX,PHX,4,35,18,7,3,63
8026,American,ATL,DEN,1,33,3,4,24,64
8027,Southwest,JFK,PHX,14,1,29,10,14,54
8028,American,DFW,SEA,23,2,9,3,28,42
8029,JetBlue,DFW,MIA,16,55,51,9,15,130
8030,JetBlue,ORD,DEN,10,52,51,12,15,130
8031,United,LAX,SEA,15,19,43,2,0,64
8032,Southwest,LAX,DEN,11,30,18,3,7,58
8033,Southwest,DFW,SEA,3,27,40,5,25,97
8034,United,DFW,PHX,12,42,10,5,14,71
8035,American,ATL,MIA,21,17,16,2,19,54
8036,Southwest,JFK,SEA,5,42,38,13,6,99
8037,JetBlue,DFW,MIA,0,42,41,2,29,114
8038,Southwest,DFW,DEN,0,31,17,13,8,69
8039,JetBlue,LAX,MIA,0,19,57,9,26,111
8040,Southwest,DFW,PHX,22,26,9,12,29,76
8041,JetBlue,ORD,SEA,6,48,57,2,1,108
8042,American,DFW,DEN,19,14,39,3,8,64
8043,Southwest,LAX,PHX,2,11,1,1,17,30
8044,JetBlue,JFK,BOS,10,52,52,11,18,133
8045,United,DFW,MIA,9,3,8,6,5,22
8046,American,ATL,PHX,18,51,57,5,26,139
8047,United,ORD,SEA,22,1,10,1,15,27
8048,Southwest,LAX,DEN,20,10,25,13,20,68
8049,United,DFW,MIA,18,26,57,0,17,100
8050,Delta,DFW,SEA,23,34,44,9,17,104
8051,Southwest,LAX,BOS,5,39,50,6,12,107
8052,JetBlue,DFW,SEA,5,6,54,0,29,89
8053,Southwest,DFW,PHX,20,52,25,0,8,85
8054,JetBlue,DFW,MIA,22,39,46,5,2,92
8055,American,LAX,PHX,17,29,11,10,21,71
8056,United,DFW,MIA,1,20,59,3,11,93
8057,American,DFW,SEA,23,53,3,9,10,75
8058,United,JFK,PHX,7,41,38,6,29,114
8059,JetBlue,LAX,MIA,0,41,3,13,4,61
8060,Southwest,JFK,MIA,11,13,27,5,13,58
8061,Southwest,ORD,BOS,1,11,17,0,10,38
8062,Delta,DFW,BOS,9,4,57,11,25,97
8063,Southwest,LAX,MIA,15,17,50,14,7,88
8064,United,LAX,DEN,9,25,5,2,28,60
8065,American,ORD,SEA,5,31,34,8,11,84
8066,Southwest,LAX,MIA,22,48,6,12,29,95
8067,United,JFK,DEN,1,41,4,7,1,53
8068,United,DFW,DEN,12,51,57,13,12,133
8069,Southwest,JFK,SEA,15,27,11,2,11,51
8070,American,LAX,SEA,1,56,35,5,0,96
8071,United,LAX,PHX,11,5,15,13,4,37
8072,Southwest,LAX,BOS,6,26,9,12,9,56
8073,American,LAX,MIA,5,16,10,8,14,48
8074,JetBlue,ORD,DEN,9,58,35,3,22,118
8075,United,ATL,PHX,3,58,2,4,27,91
8076,Southwest,JFK,DEN,12,36,54,10,19,119
8077,Southwest,ATL,BOS,11,26,55,7,24,112
8078,United,ORD,SEA,7,32,52,11,3,98
8079,United,LAX,BOS,21,15,15,11,25,66
8080,Delta,ORD,BOS,10,42,33,11,23,109
8081,JetBlue,JFK,PHX,15,18,22,1,14,55
8082,JetBlue,JFK,SEA,14,10,46,4,21,81
8083,Delta,ORD,BOS,15,32,22,4,13,71
8084,American,JFK,SEA,12,6,13,7,20,46
8085,JetBlue,DFW,PHX,0,49,46,3,16,114
8086,Delta,ATL,BOS,11,48,28,8,11,95
8087,JetBlue,DFW,MIA,4,30,10,3,19,62
8088,United,ORD,BOS,13,25,2,14,8,49
8089,Delta,ORD,DEN,4,30,36,8,5,79
8090,Delta,LAX,PHX,14,38,39,3,25,105
8091,Delta,LAX,BOS,3,16,4,5,7,32
8092,American,JFK,SEA,4,12,54,11,10,87
8093,JetBlue,ORD,PHX,18,19,41,11,23,94
8094,American,DFW,MIA,16,14,40,2,9,65
8095,Southwest,DFW,BOS,3,12,45,10,15,82
8096,Delta,LAX,BOS,22,35,56,10,20,121
8097,United,ORD,PHX,12,38,9,13,12,72
8098,Southwest,LAX,DEN,17,48,34,2,29,113
8099,United,ATL,SEA,17,56,3,0,28,87
8100,JetBlue,ATL,DEN,17,4,7,1,18,30
8101,American,ATL,SEA,13,5,16,3,8,32
8102,United,LAX,DEN,10,16,43,14,13,86
8103,United,ORD,SEA,2,57,27,9,25,118
8104,American,ATL,PHX,20,52,30,11,26,119
8105,United,ATL,SEA,6,42,13,11,6,72
8106,Southwest,DFW,SEA,0,50,40,4,5,99
8107,JetBlue,LAX,BOS,14,17,54,0,21,92
8108,Delta,JFK,BOS,13,50,58,0,27,135
8109,JetBlue,DFW,DEN,22,37,8,0,17,62
8110,JetBlue,ATL,DEN,3,47,2,4,27,80
8111,Delta,ATL,MIA,13,37,12,11,22,82
8112,American,JFK,PHX,15,41,46,8,29,124
8113,American,JFK,DEN,2,13,54,5,5,77
8114,JetBlue,ATL,BOS,16,34,39,6,17,96
8115,Southwest,ORD,SEA,18,17,13,13,26,69
8116,JetBlue,LAX,SEA,6,16,51,7,27,101
8117,American,DFW,PHX,17,9,9,9,18,45
8118,JetBlue,DFW,SEA,7,7,8,8,26,49
8119,JetBlue,LAX,DEN,3,11,57,0,10,78
8120,United,DFW,MIA,8,24,34,3,7,68
8121,United,LAX,SEA,12,44,19,11,9,83
8122,Delta,DFW,PHX,14,21,53,11,17,102
8123,American,DFW,MIA,6,22,23,2,22,69
8124,Delta,ATL,PHX,9,59,45,13,26,143
8125,United,ORD,DEN,21,43,51,8,5,107
8126,Southwest,DFW,DEN,10,41,19,4,19,83
8127,United,ATL,BOS,18,18,27,8,19,72
8128,JetBlue,DFW,BOS,22,15,18,5,7,45
8129,United,DFW,SEA,0,8,21,12,7,48
8130,Delta,JFK,SEA,4,16,21,10,15,62
8131,Southwest,ATL,MIA,8,47,4,5,8,64
8132,United,ATL,PHX,7,11,40,7,14,72
8133,American,DFW,SEA,21,19,21,14,12,66
8134,Delta,JFK,PHX,14,5,44,11,15,75
8135,Southwest,JFK,SEA,8,53,33,11,17,114
8136,JetBlue,ATL,BOS,11,1,32,9,17,59
8137,United,JFK,DEN,22,20,14,0,4,38
8138,Southwest,JFK,PHX,19,53,24,3,14,94
8139,Southwest,JFK,SEA,2,24,58,13,5,100
8140,Delta,DFW,DEN,1,21,2,10,20,53
8141,Southwest,DFW,BOS,11,13,35,7,17,72
8142,United,JFK,SEA,20,47,29,8,24,108
8143,Southwest,LAX,BOS,13,1,32,10,7,50
8144,American,DFW,DEN,15,5,7,2,15,29
8145,Delta,LAX,DEN,14,11,0,0,24,35
8146,American,LAX,BOS,4,25,30,9,24,88
8147,United,DFW,DEN,22,57,3,1,1,62
8148,Southwest,LAX,PHX,9,35,14,2,16,67
8149,Southwest,LAX,BOS,11,36,45,5,3,89
8150,Southwest,ORD,MIA,2,43,53,9,22,127
8151,United,JFK,MIA,0,12,55,12,5,84
8152,Delta,JFK,MIA,6,14,40,4,14,72
8153,Southwest,JFK,SEA,11,7,34,6,20,67
8154,Delta,DFW,MIA,11,53,11,6,23,93
8155,JetBlue,LAX,BOS,14,20,39,11,21,91
8156,Delta,JFK,SEA,4,59,57,10,24,150
8157,United,LAX,DEN,10,40,34,11,10,95
8158,Southwest,DFW,DEN,17,12,25,5,22,64
8159,United,ATL,BOS,21,38,34,13,29,114
8160,Delta,ATL,MIA,10,10,53,2,9,74
8161,American,DFW,BOS,19,12,39,6,11,68
8162,American,DFW,BOS,16,58,1,12,10,81
8163,JetBlue,ORD,DEN,17,33,8,3,4,48
8164,Southwest,JFK,MIA,10,59,13,12,2,86
8165,American,ATL,PHX,16,29,54,14,10,107
8166,United,ORD,MIA,12,8,36,6,19,69
8167,American,DFW,DEN,11,46,11,2,14,73
8168,Delta,ORD,BOS,4,49,47,4,21,121
8169,American,ATL,MIA,11,15,47,9,16,87
8170,Southwest,ORD,SEA,10,13,39,9,25,86
8171,Southwest,DFW,MIA,21,45,17,5,15,82
8172,United,JFK,DEN,2,2,6,10,12,30
8173,United,ORD,SEA,15,16,20,14,16,66
8174,American,LAX,PHX,9,10,34,4,17,65
8175,United,JFK,DEN,16,14,58,0,1,73
8176,JetBlue,ORD,DEN,11,28,17,6,10,61
8177,Southwest,JFK,PHX,6,55,20,12,6,93
8178,American,DFW,MIA,8,25,23,0,3,51
8179,Delta,ATL,SEA,15,57,47,11,20,135
8180,Delta,LAX,SEA,22,38,16,11,19,84
8181,JetBlue,ATL,DEN,10,45,42,4,8,99
8182,American,ATL,DEN,19,35,30,14,24,103
8183,American,ORD,DEN,12,28,39,1,3,71
8184,United,LAX,MIA,15,14,58,8,20,100
8185,United,LAX,BOS,1,52,30,12,12,106
8186,American,LAX,BOS,10,17,20,12,4,53
8187,United,JFK,SEA,11,12,3,12,22,49
8188,JetBlue,ATL,SEA,15,4,45,0,17,66
8189,United,LAX,BOS,1,28,39,11,6,84
8190,Southwest,DFW,SEA,1,21,50,12,7,90
8191,JetBlue,ATL,BOS,18,2,24,10,11,47
8192,Delta,LAX,MIA,1,49,25,3,27,104
8193,United,LAX,SEA,12,10,16,0,5,31
8194,American,ORD,MIA,15,33,58,8,25,124
8195,United,DFW,MIA,21,53,43,7,29,132
8196,JetBlue,ATL,DEN,18,53,0,13,26,92
8197,JetBlue,DFW,SEA,20,43,22,8,23,96
8198,Southwest,LAX,BOS,11,54,10,0,14,78
8199,American,LAX,PHX,6,45,39,8,20,112
8200,American,DFW,PHX,8,54,48,8,0,110
8201,American,DFW,BOS,19,35,22,2,0,59
8202,United,ORD,DEN,4,12,22,7,14,55
8203,Southwest,ORD,BOS,12,40,2,4,25,71
8204,American,DFW,MIA,19,29,41,11,8,89
8205,Southwest,ORD,SEA,21,27,19,7,11,64
8206,United,ATL,MIA,16,52,46,6,27,131
8207,American,ORD,BOS,16,10,47,5,9,71
8208,Southwest,DFW,MIA,8,7,48,5,26,86
8209,JetBlue,ATL,BOS,19,37,28,8,8,81
8210,Southwest,JFK,PHX,17,3,50,7,2,62
8211,Southwest,LAX,PHX,22,27,26,0,7,60
8212,Delta,DFW,SEA,8,45,36,9,15,105
8213,JetBlue,LAX,DEN,3,14,8,1,28,51
8214,JetBlue,ATL,DEN,22,26,24,10,24,84
8215,Delta,ATL,PHX,23,25,14,6,7,52
8216,Southwest,JFK,PHX,8,32,51,0,3,86
8217,Delta,DFW,MIA,2,22,49,1,7,79
8218,American,ATL,DEN,5,35,2,5,4,46
8219,Southwest,LAX,DEN,2,34,13,0,2,49
8220,JetBlue,ORD,DEN,6,40,58,4,10,112
8221,American,ORD,DEN,23,10,36,7,3,56
8222,JetBlue,LAX,MIA,4,29,12,10,15,66
8223,JetBlue,ORD,SEA,8,0,42,8,11,61
8224,United,DFW,DEN,18,48,58,12,4,122
8225,Southwest,DFW,PHX,14,26,20,5,18,69
8226,American,JFK,MIA,15,51,41,14,27,133
8227,United,ATL,BOS,9,32,10,4,2,48
8228,Delta,JFK,BOS,17,46,35,2,16,99
8229,American,ATL,MIA,21,46,47,5,20,118
8230,United,LAX,BOS,23,39,1,7,3,50
8231,JetBlue,ORD,PHX,5,47,42,5,8,102
8232,American,JFK,SEA,14,28,49,9,8,94
8233,JetBlue,DFW,PHX,7,2,6,6,23,37
8234,JetBlue,LAX,DEN,17,10,39,13,7,69
8235,American,ATL,SEA,17,35,20,5,12,72
8236,JetBlue,DFW,BOS,23,48,17,14,27,106
8237,Southwest,JFK,BOS,17,7,48,4,24,83
8238,Delta,JFK,SEA,23,45,22,10,4,81
8239,United,ORD,MIA,15,9,49,14,12,84
8240,United,JFK,DEN,22,3,54,14,24,95
8241,Southwest,ORD,MIA,17,19,1,6,9,35
8242,Delta,ORD,MIA,6,47,43,3,20,113
8243,United,JFK,PHX,5,37,33,0,18,88
8244,Southwest,DFW,SEA,13,36,7,12,23,78
8245,United,ORD,PHX,7,26,39,8,15,88
8246,United,DFW,SEA,17,26,9,0,7,42
8247,Southwest,LAX,DEN,17,58,0,2,14,74
8248,Delta,DFW,SEA,2,17,1,5,1,24
8249,American,ATL,DEN,18,54,39,12,7,112
8250,JetBlue,JFK,SEA,4,0,29,2,24,55
8251,Southwest,ATL,MIA,14,43,50,6,18,117
8252,United,ORD,BOS,18,41,3,3,9,56
8253,United,DFW,BOS,9,59,26,10,1,96
8254,Delta,ORD,MIA,19,43,11,6,27,87
8255,United,JFK,SEA,20,6,59,9,3,77
8256,Southwest,ATL,MIA,10,57,16,7,27,107
8257,Delta,ATL,DEN,1,15,15,12,28,70
8258,Delta,ORD,MIA,22,28,37,4,25,94
8259,Southwest,JFK,PHX,17,32,21,13,10,76
8260,JetBlue,ATL,DEN,3,48,16,10,25,99
8261,Delta,ORD,PHX,20,9,19,9,15,52
8262,United,JFK,SEA,4,39,44,1,23,107
8263,Southwest,ATL,BOS,20,9,57,5,10,81
8264,Delta,DFW,SEA,13,41,10,0,15,66
8265,Delta,ATL,PHX,9,59,23,3,27,112
8266,United,DFW,SEA,15,27,37,6,19,89
8267,American,DFW,SEA,7,41,1,11,11,64
8268,Delta,ORD,PHX,0,52,0,14,29,95
8269,Southwest,LAX,SEA,22,34,57,0,22,113
8270,American,LAX,BOS,9,35,25,5,18,83
8271,American,DFW,SEA,19,36,26,1,7,70
8272,Delta,ATL,MIA,8,12,43,10,23,88
8273,Southwest,DFW,BOS,11,17,41,13,15,86
8274,JetBlue,DFW,MIA,20,14,32,6,7,59
8275,Southwest,LAX,SEA,19,18,56,12,18,104
8276,American,JFK,DEN,1,37,59,12,18,126
8277,American,ORD,BOS,19,43,50,4,6,103
8278,Southwest,ATL,PHX,22,21,38,10,12,81
8279,JetBlue,JFK,PHX,5,34,17,11,6,68
8280,Delta,JFK,SEA,0,30,1,2,15,48
8281,American,DFW,BOS,5,10,36,3,17,66
8282,Delta,JFK,PHX,2,20,40,4,26,90
8283,American,JFK,PHX,8,31,50,10,24,115
8284,United,ATL,MIA,17,31,3,11,7,52
8285,Southwest,DFW,MIA,12,32,32,4,20,88
8286,United,DFW,BOS,16,10,55,1,4,70
8287,United,LAX,SEA,7,38,18,9,2,67
8288,JetBlue,DFW,MIA,8,29,7,5,5,46
8289,United,ORD,BOS,10,1,16,1,25,43
8290,American,LAX,PHX,2,33,31,2,20,86
8291,American,ORD,PHX,3,47,39,10,12,108
8292,Delta,DFW,SEA,13,58,44,0,13,115
8293,Southwest,LAX,SEA,19,21,5,13,28,67
8294,Southwest,ORD,SEA,20,14,3,0,10,27
8295,Southwest,ATL,MIA,11,52,43,9,29,133
8296,JetBlue,LAX,DEN,4,17,5,8,20,50
8297,Southwest,LAX,BOS,1,49,23,13,7,92
8298,United,ORD,DEN,12,45,22,9,14,90
8299,Delta,ATL,SEA,1,7,31,9,23,70
8300,American,JFK,SEA,0,11,33,14,6,64
8301,Delta,DFW,DEN,4,57,29,4,21,111
8302,Delta,DFW,PHX,19,9,15,8,21,53
8303,American,JFK,PHX,1,14,24,4,4,46
8304,United,ATL,MIA,10,55,23,14,22,114
8305,American,ATL,BOS,17,3,20,10,25,58
8306,American,JFK,PHX,10,2,31,4,6,43
8307,JetBlue,JFK,MIA,13,51,52,10,28,141
8308,JetBlue,DFW,MIA,8,21,58,8,6,93
8309,JetBlue,JFK,DEN,17,22,20,9,18,69
8310,Southwest,ATL,SEA,18,29,26,2,5,62
8311,United,LAX,DEN,16,46,54,13,6,119
8312,Delta,JFK,DEN,12,56,2,3,28,89
8313,JetBlue,JFK,BOS,0,30,54,4,23,111
8314,Delta,ORD,SEA,21,54,38,4,20,116
8315,JetBlue,ORD,BOS,16,11,51,3,16,81
8316,Southwest,JFK,MIA,12,19,51,3,16,89
8317,JetBlue,ORD,MIA,8,30,54,7,28,119
8318,Delta,JFK,MIA,6,14,37,7,15,73
8319,Southwest,JFK,SEA,17,44,32,14,0,90
8320,Southwest,ATL,PHX,20,53,17,1,3,74
8321,American,ORD,SEA,8,34,57,6,2,99
8322,JetBlue,JFK,PHX,13,4,46,0,0,50
8323,Delta,JFK,SEA,1,33,28,1,8,70
8324,American,JFK,PHX,17,22,58,3,28,111
8325,American,ORD,MIA,16,4,46,7,0,57
8326,American,ATL,SEA,16,9,20,7,19,55
8327,Southwest,ORD,PHX,15,37,30,6,10,83
8328,American,LAX,BOS,10,54,27,0,6,87
8329,JetBlue,ORD,MIA,21,57,46,8,10,121
8330,American,LAX,BOS,19,56,16,6,26,104
8331,Southwest,JFK,PHX,8,23,34,6,19,82
8332,Delta,ATL,DEN,2,52,57,1,6,116
8333,JetBlue,ATL,SEA,23,19,1,4,27,51
8334,American,LAX,DEN,3,33,43,12,23,111
8335,Southwest,LAX,MIA,6,0,42,9,20,71
8336,United,ATL,DEN,17,32,41,5,25,103
8337,Southwest,ORD,PHX,5,43,47,8,1,99
8338,United,JFK,BOS,3,25,47,11,23,106
8339,United,JFK,PHX,1,40,44,1,23,108
8340,Delta,JFK,BOS,1,52,41,6,29,128
8341,Delta,LAX,BOS,0,46,11,7,10,74
8342,Delta,LAX,PHX,4,55,5,11,28,99
8343,Southwest,ATL,PHX,4,59,51,12,17,139
8344,JetBlue,ATL,DEN,16,20,13,6,15,54
8345,United,ATL,MIA,12,51,32,9,7,99
8346,Southwest,ATL,DEN,5,41,33,8,27,109
8347,American,LAX,MIA,6,14,21,7,7,49
8348,American,JFK,BOS,9,55,10,6,20,91
8349,Delta,ORD,DEN,12,6,2,8,7,23
8350,American,JFK,MIA,2,33,20,13,0,66
8351,United,ATL,SEA,6,21,46,2,7,76
8352,United,ORD,SEA,4,4,20,13,15,52
8353,American,DFW,SEA,22,35,35,9,4,83
8354,Delta,DFW,MIA,8,13,20,2,5,40
8355,Delta,JFK,DEN,2,55,34,7,20,116
8356,Delta,LAX,SEA,15,33,11,12,23,79
8357,United,ATL,SEA,19,12,9,11,3,35
8358,United,JFK,BOS,15,48,50,11,13,122
8359,United,DFW,MIA,8,16,42,7,8,73
8360,United,ORD,MIA,12,26,59,2,9,96
8361,Southwest,LAX,BOS,15,31,26,5,26,88
8362,Delta,ATL,MIA,4,6,18,9,8,41
8363,Delta,DFW,SEA,15,50,1,10,21,82
8364,American,ORD,PHX,0,17,6,6,8,37
8365,Southwest,LAX,PHX,15,11,5,10,25,51
8366,American,ORD,PHX,3,36,59,13,15,123
8367,JetBlue,LAX,SEA,2,25,1,9,12,47
8368,United,ORD,DEN,10,36,41,14,28,119
8369,JetBlue,ATL,BOS,20,37,16,7,22,82
8370,Southwest,JFK,MIA,4,22,32,14,24,92
8371,JetBlue,LAX,BOS,9,11,27,4,11,53
8372,United,DFW,MIA,3,11,42,5,23,81
8373,American,ORD,PHX,11,41,6,3,27,77
8374,American,LAX,DEN,12,46,21,10,8,85
8375,American,DFW,MIA,10,30,48,14,13,105
8376,American,DFW,MIA,23,11,30,6,20,67
8377,Delta,ORD,MIA,14,59,12,0,9,80
8378,Southwest,DFW,PHX,11,47,40,6,17,110
8379,JetBlue,ORD,DEN,22,51,45,8,29,133
8380,JetBlue,ORD,PHX,16,55,56,4,18,133
8381,Delta,ORD,SEA,12,21,40,0,23,84
8382,United,JFK,SEA,18,1,12,4,5,22
8383,JetBlue,ATL,PHX,12,10,34,6,21,71
8384,United,ATL,DEN,23,5,13,1,4,23
8385,Delta,JFK,BOS,13,0,7,2,26,35
8386,Southwest,DFW,SEA,4,45,51,5,23,124
8387,American,LAX,PHX,2,5,58,12,17,92
8388,United,JFK,PHX,15,57,42,13,18,130
8389,American,ATL,SEA,11,9,37,14,13,73
8390,Southwest,LAX,DEN,13,46,3,13,28,90
8391,Southwest,JFK,PHX,17,37,22,11,5,75
8392,Southwest,JFK,BOS,0,15,52,3,6,76
8393,Southwest,DFW,PHX,5,9,9,8,6,32
8394,United,ATL,SEA,2,9,5,1,7,22
8395,American,JFK,PHX,16,50,6,3,0,59
8396,Delta,JFK,BOS,7,25,17,1,5,48
8397,JetBlue,JFK,PHX,23,40,6,4,5,55
8398,Delta,ORD,SEA,21,29,48,6,15,98
8399,American,DFW,SEA,1,42,30,3,21,96
8400,United,ORD,MIA,4,39,39,11,24,113
8401,Delta,DFW,PHX,5,20,0,6,26,52
8402,American,ATL,DEN,8,8,46,4,12,70
8403,American,JFK,MIA,16,39,29,2,15,85
8404,American,DFW,BOS,10,14,17,1,26,58
8405,United,LAX,MIA,1,48,30,8,17,103
8406,Delta,LAX,SEA,18,21,14,2,19,56
8407,American,DFW,MIA,13,20,42,3,17,82
8408,American,ORD,DEN,5,44,51,8,11,114
8409,Southwest,JFK,PHX,0,56,48,13,13,130
8410,Southwest,ATL,PHX,12,45,24,5,14,88
8411,Delta,LAX,PHX,18,6,19,7,27,59
8412,Delta,JFK,MIA,16,25,53,7,16,101
8413,JetBlue,LAX,MIA,9,15,15,6,20,56
8414,JetBlue,ORD,PHX,12,46,6,6,14,72
8415,Southwest,ORD,MIA,0,52,11,12,26,101
8416,JetBlue,DFW,SEA,8,41,15,8,3,67
8417,Delta,ATL,BOS,4,58,31,5,29,123
8418,Delta,LAX,SEA,0,44,3,12,23,82
8419,Delta,DFW,PHX,16,36,2,8,8,54
8420,United,DFW,SEA,11,58,17,6,18,99
8421,JetBlue,ORD,MIA,15,38,40,7,18,103
8422,Southwest,DFW,BOS,2,25,16,14,9,64
8423,United,JFK,DEN,5,16,58,2,5,81
8424,Southwest,LAX,DEN,21,3,10,0,15,28
8425,American,DFW,MIA,22,24,41,14,8,87
8426,United,DFW,MIA,4,7,54,13,6,80
8427,JetBlue,JFK,PHX,22,52,41,12,6,111
8428,United,DFW,DEN,10,9,38,8,22,77
8429,American,LAX,BOS,23,34,50,4,15,103
8430,American,LAX,SEA,4,4,6,1,21,32
8431,JetBlue,LAX,BOS,23,56,22,12,17,107
8432,Southwest,ORD,PHX,18,28,15,12,22,77
8433,American,LAX,MIA,22,5,14,13,10,42
8434,JetBlue,JFK,MIA,22,29,26,7,19,81
8435,United,JFK,BOS,13,51,3,4,27,85
8436,United,LAX,SEA,22,53,49,7,29,138
8437,Delta,LAX,DEN,12,35,5,9,18,67
8438,JetBlue,LAX,PHX,22,18,29,12,15,74
8439,Delta,JFK,MIA,9,46,24,14,14,98
8440,American,DFW,DEN,23,57,11,5,17,90
8441,American,LAX,PHX,13,1,18,2,9,30
8442,Southwest,ORD,SEA,14,58,22,1,15,96
8443,Southwest,DFW,DEN,15,18,4,12,25,59
8444,Southwest,LAX,MIA,17,6,50,5,26,87
8445,JetBlue,LAX,DEN,23,3,5,4,21,33
8446,Delta,JFK,PHX,8,31,45,14,11,101
8447,JetBlue,JFK,BOS,15,47,45,9,23,124
8448,American,ORD,DEN,9,39,49,4,6,98
8449,United,ATL,BOS,14,38,47,14,5,104
8450,Southwest,ORD,PHX,14,11,40,14,1,66
8451,United,DFW,SEA,0,7,49,9,27,92
8452,Delta,JFK,BOS,7,42,59,4,18,123
8453,Southwest,ORD,DEN,14,12,39,1,28,80
8454,United,DFW,BOS,7,5,1,3,5,14
8455,Delta,LAX,DEN,3,23,27,3,2,55
8456,Southwest,ORD,MIA,1,24,38,1,21,84
8457,JetBlue,ORD,MIA,8,13,55,6,13,87
8458,Southwest,ORD,BOS,14,44,9,13,21,87
8459,Southwest,DFW,DEN,14,36,43,9,12,100
8460,JetBlue,ORD,PHX,6,56,30,0,25,111
8461,American,ORD,DEN,5,30,23,8,15,76
8462,Southwest,ATL,PHX,21,12,57,1,1,71
8463,American,DFW,BOS,12,8,45,4,10,67
8464,American,JFK,DEN,6,38,47,8,22,115
8465,American,DFW,BOS,22,5,51,4,2,62
8466,Delta,DFW,SEA,20,51,53,6,11,121
8467,Delta,JFK,PHX,15,14,30,9,17,70
8468,United,ORD,BOS,8,19,28,2,21,70
8469,Delta,DFW,BOS,2,57,39,12,19,127
8470,United,DFW,MIA,11,21,8,6,5,40
8471,JetBlue,LAX,BOS,18,53,24,2,8,87
8472,JetBlue,JFK,SEA,10,30,41,2,22,95
8473,American,JFK,SEA,18,25,29,6,22,82
8474,American,ORD,BOS,15,57,48,3,0,108
8475,Delta,LAX,MIA,20,59,49,1,19,128
8476,JetBlue,ORD,MIA,2,22,20,9,13,64
8477,Southwest,JFK,SEA,15,5,34,0,13,52
8478,Southwest,DFW,SEA,7,47,22,13,23,105
8479,Delta,LAX,BOS,12,14,5,9,7,35
8480,American,ORD,MIA,9,44,32,1,23,100
8481,American,ATL,DEN,17,31,26,8,22,87
8482,Southwest,ORD,MIA,0,40,47,12,7,106
8483,JetBlue,LAX,MIA,17,37,34,12,8,91
8484,United,JFK,PHX,7,58,9,9,14,90
8485,Delta,ORD,PHX,20,42,42,7,21,112
8486,American,ATL,SEA,22,30,49,10,11,100
8487,American,DFW,DEN,7,19,17,7,13,56
8488,JetBlue,LAX,BOS,20,53,36,6,0,95
8489,United,ATL,DEN,4,18,34,1,1,54
8490,American,JFK,MIA,5,20,19,8,29,76
8491,JetBlue,DFW,SEA,13,40,44,7,15,106
8492,Delta,JFK,MIA,16,46,41,5,4,96
8493,JetBlue,DFW,DEN,23,24,48,10,8,90
8494,American,JFK,BOS,7,56,25,3,2,86
8495,United,LAX,SEA,19,42,14,4,25,85
8496,United,ORD,BOS,18,41,7,9,7,64
8497,American,JFK,SEA,22,6,11,13,0,30
8498,Southwest,ATL,DEN,11,51,21,4,29,105
8499,United,LAX,DEN,16,35,15,9,11,70
8500,American,JFK,DEN,23,39,53,5,19,116
8501,JetBlue,LAX,PHX,7,1,26,8,13,48
8502,Southwest,JFK,MIA,8,30,23,3,8,64
8503,Delta,DFW,DEN,2,49,25,9,16,99
8504,JetBlue,JFK,DEN,3,59,59,3,23,144
8505,JetBlue,JFK,PHX,20,7,16,7,13,43
8506,United,DFW,MIA,4,11,17,8,17,53
8507,United,DFW,DEN,9,17,50,14,17,98
8508,Southwest,DFW,DEN,14,9,52,4,9,74
8509,Delta,ORD,BOS,3,13,10,4,6,33
8510,Delta,ATL,BOS,11,29,12,8,23,72
8511,Southwest,ATL,SEA,11,27,37,7,15,86
8512,Southwest,DFW,BOS,3,35,36,11,19,101
8513,United,ATL,BOS,17,5,52,4,2,63
8514,United,ORD,DEN,14,41,10,4,2,57
8515,Southwest,ORD,MIA,4,26,9,4,1,40
8516,Delta,DFW,SEA,4,38,51,14,20,123
8517,American,LAX,BOS,6,59,19,7,7,92
8518,JetBlue,JFK,PHX,14,46,46,7,15,114
8519,United,LAX,MIA,5,50,36,8,9,103
8520,Delta,JFK,BOS,15,7,34,2,5,48
8521,JetBlue,ORD,BOS,17,58,57,11,28,154
8522,American,ATL,MIA,14,54,33,7,20,114
8523,JetBlue,JFK,MIA,5,31,46,4,18,99
8524,JetBlue,JFK,PHX,8,54,37,4,22,117
8525,United,ATL,DEN,22,50,12,9,8,79
8526,JetBlue,DFW,DEN,5,9,14,10,15,48
8527,American,ORD,SEA,12,11,3,13,0,27
8528,American,LAX,SEA,15,36,55,6,4,101
8529,Southwest,ORD,MIA,23,28,41,6,20,95
8530,JetBlue,ATL,PHX,22,1,10,3,7,21
8531,JetBlue,ORD,MIA,3,3,19,6,18,46
8532,United,ATL,BOS,14,23,29,2,16,70
8533,JetBlue,JFK,DEN,1,14,3,12,10,39
8534,American,JFK,DEN,23,3,29,2,2,36
8535,Delta,ATL,DEN,4,18,35,4,12,69
8536,Delta,ORD,BOS,13,49,2,10,21,82
8537,JetBlue,ORD,MIA,11,1,27,12,24,64
8538,Southwest,ORD,DEN,4,56,32,11,8,107
8539,Delta,DFW,SEA,14,12,20,7,7,46
8540,JetBlue,JFK,PHX,8,42,26,9,28,105
8541,Southwest,JFK,BOS,18,37,49,14,17,117
8542,JetBlue,LAX,DEN,23,44,37,5,14,100
8543,JetBlue,ORD,BOS,8,21,21,3,6,51
8544,Delta,JFK,BOS,20,2,44,14,18,78
8545,United,LAX,BOS,7,14,7,2,22,45
8546,Southwest,DFW,BOS,19,45,20,9,6,80
8547,Southwest,ATL,BOS,8,46,41,11,13,111
8548,Southwest,JFK,PHX,9,43,24,10,23,100
8549,American,JFK,SEA,11,50,4,10,13,77
8550,American,JFK,DEN,3,8,12,2,5,27
8551,Delta,DFW,DEN,20,14,37,3,0,54
8552,JetBlue,DFW,SEA,2,15,50,3,19,87
8553,United,DFW,BOS,13,9,35,13,29,86
8554,Delta,ORD,MIA,12,43,21,1,8,73
8555,American,ATL,BOS,15,45,20,5,15,85
8556,United,LAX,BOS,12,6,38,12,16,72
8557,Southwest,JFK,MIA,19,45,49,14,10,118
8558,United,ATL,DEN,1,59,25,8,8,100
8559,American,ATL,MIA,10,34,39,5,18,96
8560,Delta,ORD,DEN,12,59,40,7,16,122
8561,Delta,LAX,PHX,1,32,9,6,25,72
8562,Southwest,DFW,BOS,14,37,52,14,7,110
8563,Delta,DFW,PHX,9,46,43,2,19,110
8564,United,JFK,MIA,22,1,29,7,17,54
8565,United,ATL,PHX,9,44,36,2,18,100
8566,Delta,ATL,BOS,5,15,49,9,1,74
8567,Delta,ATL,SEA,10,38,34,10,19,101
8568,Southwest,JFK,PHX,4,43,20,14,23,100
8569,Southwest,ATL,SEA,14,0,59,4,19,82
8570,American,ORD,MIA,23,14,7,3,20,44
8571,JetBlue,DFW,BOS,10,57,25,2,23,107
8572,Southwest,ORD,PHX,7,16,20,10,20,66
8573,United,ORD,MIA,9,26,1,11,21,59
8574,JetBlue,LAX,MIA,20,38,33,5,2,78
8575,United,ORD,MIA,11,34,3,8,22,67
8576,United,DFW,MIA,0,31,31,14,28,104
8577,American,LAX,SEA,1,8,58,2,14,82
8578,American,LAX,MIA,0,21,42,2,17,82
8579,Southwest,LAX,DEN,19,49,5,2,26,82
8580,Delta,DFW,PHX,20,23,28,0,2,53
8581,Delta,DFW,DEN,6,30,22,4,24,80
8582,JetBlue,DFW,MIA,22,25,9,8,7,49
8583,American,ORD,PHX,6,20,14,0,13,47
8584,Delta,ORD,SEA,17,3,58,3,3,67
8585,United,LAX,DEN,4,8,5,3,22,38
8586,Southwest,DFW,PHX,11,33,52,2,14,101
8587,Southwest,ORD,DEN,6,37,25,9,14,85
8588,Delta,DFW,BOS,4,45,56,14,15,130
8589,American,ORD,MIA,7,40,6,14,12,72
8590,American,DFW,PHX,23,45,26,0,20,91
8591,United,ORD,DEN,23,16,43,10,24,93
8592,JetBlue,ATL,SEA,14,9,36,10,8,63
8593,American,DFW,DEN,18,14,52,9,21,96
8594,Southwest,ORD,SEA,14,42,17,5,3,67
8595,United,ATL,MIA,5,19,27,5,19,70
8596,American,LAX,PHX,7,45,35,14,9,103
8597,United,JFK,SEA,14,48,57,10,4,119
8598,Delta,ORD,BOS,19,23,31,8,10,72
8599,United,LAX,DEN,5,3,34,2,22,61
8600,American,LAX,BOS,20,14,33,4,3,54
8601,American,ORD,PHX,15,41,20,6,28,95
8602,American,DFW,MIA,20,55,47,14,19,135
8603,Southwest,JFK,PHX,23,59,33,8,9,109
8604,United,ATL,SEA,9,40,44,2,18,104
8605,Southwest,ATL,MIA,18,44,55,9,0,108
8606,United,ATL,DEN,8,50,11,1,6,68
8607,Southwest,LAX,DEN,14,29,32,5,22,88
8608,Southwest,DFW,SEA,12,8,22,2,24,56
8609,American,JFK,SEA,16,5,56,9,10,80
8610,United,ORD,DEN,7,45,52,13,20,130
8611,United,JFK,SEA,6,44,55,9,17,125
8612,United,DFW,PHX,3,44,36,4,21,105
8613,American,JFK,DEN,2,52,22,7,1,82
8614,Southwest,ATL,PHX,11,21,8,1,29,59
8615,United,JFK,MIA,18,9,52,5,29,95
8616,JetBlue,DFW,SEA,16,11,54,13,20,98
8617,Delta,DFW,BOS,14,16,22,4,29,71
8618,JetBlue,ORD,BOS,20,1,16,9,24,50
8619,Southwest,LAX,SEA,11,20,39,14,19,92
8620,Southwest,ORD,DEN,21,32,44,6,13,95
8621,United,LAX,SEA,4,46,21,10,11,88
8622,United,DFW,PHX,7,1,47,6,19,73
8623,American,DFW,DEN,6,17,39,4,16,76
8624,United,DFW,SEA,2,36,30,11,14,91
8625,American,ATL,DEN,18,22,11,8,25,66
8626,JetBlue,JFK,MIA,19,42,38,1,3,84
8627,United,ATL,SEA,21,57,59,6,10,132
8628,Delta,DFW,SEA,23,9,5,4,25,43
8629,Southwest,LAX,PHX,11,27,44,8,17,96
8630,JetBlue,ATL,DEN,3,57,38,5,5,105
8631,United,JFK,DEN,23,22,56,7,29,114
8632,JetBlue,DFW,SEA,4,12,15,9,22,58
8633,Delta,DFW,DEN,9,58,48,7,2,115
8634,Southwest,JFK,SEA,17,47,40,3,10,100
8635,JetBlue,JFK,DEN,2,27,1,4,7,39
8636,JetBlue,ORD,MIA,13,24,0,9,0,33
8637,American,DFW,PHX,8,16,26,14,17,73
8638,JetBlue,ORD,SEA,19,28,19,13,7,67
8639,JetBlue,ORD,BOS,19,16,7,11,21,55
8640,Delta,ORD,MIA,2,46,7,5,7,65
8641,Delta,DFW,MIA,18,52,24,2,9,87
8642,Southwest,JFK,BOS,3,43,41,13,9,106
8643,Delta,LAX,DEN,20,1,57,1,17,76
8644,American,ATL,DEN,14,24,56,13,27,120
8645,American,LAX,MIA,6,41,15,14,24,94
8646,Delta,JFK,MIA,14,29,20,8,11,68
8647,Delta,ATL,PHX,18,8,37,11,29,85
8648,American,JFK,BOS,14,52,25,2,21,100
8649,Southwest,ORD,SEA,3,6,43,3,0,52
8650,Delta,LAX,PHX,18,53,45,10,3,111
8651,Southwest,ORD,DEN,9,51,20,13,12,96
8652,American,LAX,MIA,8,15,23,10,13,61
8653,Delta,DFW,SEA,4,49,20,6,28,103
8654,United,ORD,MIA,21,46,2,6,23,77
8655,American,ORD,MIA,5,0,56,5,7,68
8656,Delta,LAX,BOS,6,1,44,1,26,72
8657,American,DFW,PHX,11,9,5,3,13,30
8658,Delta,LAX,PHX,10,5,56,8,10,79
8659,United,DFW,BOS,3,59,4,14,1,78
8660,Delta,JFK,SEA,16,46,43,7,17,113
8661,JetBlue,LAX,MIA,4,27,50,1,20,98
8662,American,DFW,BOS,11,28,5,0,6,39
8663,Southwest,JFK,MIA,14,29,11,5,0,45
8664,JetBlue,LAX,BOS,8,18,8,5,7,38
8665,American,DFW,SEA,5,21,19,8,4,52
8666,JetBlue,ATL,DEN,17,8,8,2,1,19
8667,Delta,ATL,DEN,11,54,37,1,13,105
8668,Southwest,ORD,MIA,0,57,31,10,26,124
8669,Southwest,DFW,DEN,17,8,59,0,6,73
8670,United,DFW,BOS,7,32,35,12,12,91
8671,United,JFK,MIA,8,49,6,10,22,87
8672,Delta,ORD,BOS,10,3,51,13,21,88
8673,American,JFK,PHX,11,13,40,13,29,95
8674,Delta,ATL,PHX,2,48,34,12,12,106
8675,United,ORD,PHX,18,43,35,14,3,95
8676,JetBlue,DFW,SEA,23,32,13,8,21,74
8677,American,ORD,MIA,4,27,44,11,13,95
8678,United,DFW,DEN,6,39,47,5,23,114
8679,American,JFK,PHX,6,35,59,10,2,106
8680,American,DFW,PHX,18,45,22,3,18,88
8681,United,LAX,PHX,12,53,11,14,26,104
8682,American,DFW,PHX,3,44,37,9,24,114
8683,Southwest,JFK,BOS,6,34,52,1,9,96
8684,United,LAX,SEA,3,36,50,8,2,96
8685,American,JFK,MIA,8,13,56,8,13,90
8686,Southwest,JFK,PHX,6,30,43,13,1,87
8687,Southwest,ATL,SEA,8,34,47,3,22,106
8688,American,JFK,BOS,19,37,59,0,0,96
8689,JetBlue,DFW,MIA,9,56,55,14,28,153
8690,United,DFW,BOS,10,17,27,3,21,68
8691,United,ATL,SEA,5,37,0,9,7,53
8692,American,LAX,DEN,4,17,15,4,13,49
8693,Southwest,DFW,SEA,3,9,37,8,27,81
8694,United,JFK,DEN,8,4,57,0,23,84
8695,United,JFK,SEA,23,45,22,13,27,107
8696,JetBlue,JFK,MIA,12,52,29,3,24,108
8697,United,DFW,PHX,6,57,21,14,26,118
8698,Southwest,LAX,BOS,13,51,19,5,14,89
8699,Southwest,JFK,DEN,10,52,30,7,27,116
8700,Delta,DFW,SEA,9,43,42,9,28,122
8701,American,LAX,DEN,18,20,8,6,20,54
8702,JetBlue,DFW,DEN,5,7,18,12,26,63
8703,American,DFW,SEA,7,30,4,11,8,53
8704,JetBlue,ORD,DEN,12,8,51,11,29,99
8705,Southwest,LAX,SEA,16,40,7,4,14,65
8706,Southwest,ORD,SEA,13,40,0,9,16,65
8707,JetBlue,ORD,PHX,19,20,22,8,28,78
8708,American,ATL,PHX,11,47,40,12,0,99
8709,Delta,ATL,PHX,19,57,22,12,18,109
8710,JetBlue,ATL,DEN,15,11,18,5,6,40
8711,American,ATL,BOS,3,55,20,13,26,114
8712,American,ATL,PHX,23,41,5,4,10,60
8713,Delta,LAX,BOS,2,10,19,0,5,34
8714,Delta,ATL,PHX,6,10,12,11,21,54
8715,Southwest,DFW,DEN,21,17,26,6,7,56
8716,American,LAX,BOS,1,53,28,14,22,117
8717,Southwest,DFW,PHX,17,1,41,0,16,58
8718,American,ORD,MIA,21,23,22,8,23,76
8719,Delta,DFW,SEA,0,46,57,0,18,121
8720,Delta,DFW,PHX,13,56,11,5,19,91
8721,Delta,ORD,SEA,23,56,51,7,15,129
8722,Delta,ATL,PHX,0,24,45,5,25,99
8723,United,DFW,DEN,0,39,35,7,10,91
8724,Southwest,JFK,BOS,20,24,50,11,3,88
8725,United,ORD,PHX,6,39,0,8,14,61
8726,United,ORD,SEA,15,43,33,12,27,115
8727,Southwest,ATL,SEA,12,30,17,13,10,70
8728,American,ORD,MIA,5,35,21,8,4,68
8729,American,DFW,MIA,6,21,28,8,23,80
8730,United,LAX,PHX,18,46,16,13,17,92
8731,United,JFK,DEN,0,19,51,6,2,78
8732,Southwest,LAX,DEN,8,14,45,0,27,86
8733,JetBlue,ORD,DEN,4,36,26,12,18,92
8734,JetBlue,ATL,BOS,7,54,48,4,21,127
8735,Southwest,JFK,SEA,3,8,27,11,3,49
8736,American,LAX,SEA,5,43,47,11,24,125
8737,American,LAX,MIA,1,1,52,8,29,90
8738,American,JFK,BOS,21,56,6,7,11,80
8739,Southwest,LAX,SEA,5,0,31,12,28,71
8740,American,ATL,PHX,22,35,29,7,20,91
8741,Delta,ORD,SEA,9,47,3,6,17,73
8742,United,ATL,SEA,12,49,39,4,18,110
8743,United,ATL,PHX,9,17,11,2,0,30
8744,Delta,ORD,BOS,18,58,52,0,24,134
8745,United,ORD,BOS,11,33,51,4,28,116
8746,Delta,DFW,PHX,15,3,59,12,12,86
8747,American,ORD,PHX,15,42,29,12,12,95
8748,American,DFW,PHX,11,35,41,10,20,106
8749,Delta,LAX,PHX,1,24,36,13,8,81
8750,Delta,JFK,DEN,7,5,14,3,1,23
8751,American,LAX,BOS,8,59,36,5,21,121
8752,American,ORD,BOS,16,15,30,4,21,70
8753,American,LAX,PHX,4,49,28,13,25,115
8754,American,ORD,BOS,18,58,3,1,4,66
8755,United,DFW,BOS,23,51,30,12,13,106
8756,Southwest,JFK,PHX,11,39,1,14,14,68
8757,United,LAX,DEN,2,23,31,10,18,82
8758,JetBlue,DFW,MIA,18,25,33,8,7,73
8759,Southwest,LAX,DEN,13,22,35,11,25,93
8760,United,ATL,BOS,11,16,41,10,5,72
8761,United,ORD,DEN,13,27,52,10,10,99
8762,Southwest,LAX,BOS,14,50,59,5,24,138
8763,American,DFW,DEN,16,22,7,9,4,42
8764,Southwest,DFW,BOS,7,50,54,0,20,124
8765,Southwest,JFK,SEA,15,48,44,12,8,112
8766,Southwest,LAX,SEA,15,15,25,5,24,69
8767,JetBlue,ORD,SEA,16,42,43,2,3,90
8768,United,LAX,SEA,15,50,22,3,7,82
8769,American,LAX,MIA,12,0,26,0,11,37
8770,Southwest,ATL,DEN,8,6,21,4,0,31
8771,Southwest,DFW,SEA,14,9,33,9,26,77
8772,Delta,ORD,MIA,0,43,38,8,19,108
8773,Delta,ORD,PHX,21,17,35,9,23,84
8774,Delta,LAX,SEA,15,31,52,11,0,94
8775,Southwest,JFK,BOS,6,30,24,1,27,82
8776,United,DFW,MIA,2,17,48,5,6,76
8777,Southwest,ORD,SEA,23,27,24,2,16,69
8778,United,JFK,DEN,22,37,43,1,5,86
8779,Delta,ORD,BOS,16,24,51,6,28,109
8780,American,JFK,DEN,0,9,7,6,0,22
8781,United,ORD,MIA,16,36,18,5,29,88
8782,Southwest,DFW,SEA,16,47,35,12,27,121
8783,Southwest,ORD,MIA,0,54,39,7,19,119
8784,Delta,DFW,BOS,15,42,24,3,1,70
8785,United,ATL,SEA,19,20,11,10,8,49
8786,Southwest,ORD,MIA,16,12,41,13,8,74
8787,Southwest,ATL,DEN,7,56,2,4,24,86
8788,United,JFK,BOS,8,56,29,12,9,106
8789,Southwest,JFK,DEN,19,9,12,8,28,57
8790,American,JFK,BOS,18,59,3,8,25,95
8791,United,LAX,SEA,7,12,28,4,10,54
8792,American,ATL,MIA,12,33,36,14,12,95
8793,JetBlue,LAX,SEA,0,46,0,14,18,78
8794,American,LAX,DEN,23,7,31,9,23,70
8795,JetBlue,LAX,SEA,18,13,13,12,3,41
8796,JetBlue,ATL,PHX,4,55,11,1,19,86
8797,United,JFK,PHX,4,32,52,11,9,104
8798,JetBlue,LAX,BOS,23,27,41,11,3,82
8799,American,DFW,SEA,17,24,13,5,1,43
8800,Delta,ORD,SEA,16,55,7,14,7,83
8801,American,LAX,PHX,7,16,24,11,1,52
8802,Southwest,LAX,DEN,4,30,59,12,25,126
8803,JetBlue,ORD,DEN,14,28,3,9,17,57
8804,JetBlue,LAX,SEA,2,9,20,3,12,44
8805,American,DFW,SEA,21,9,29,14,4,56
8806,Delta,JFK,BOS,6,37,1,9,7,54
8807,JetBlue,ATL,PHX,12,48,16,6,8,78
8808,American,ORD,MIA,2,41,33,14,12,100
8809,Southwest,DFW,PHX,19,57,32,7,14,110
8810,Delta,JFK,PHX,0,56,12,4,19,91
8811,Delta,DFW,SEA,11,49,59,8,10,126
8812,JetBlue,DFW,MIA,22,41,39,11,24,115
8813,Delta,DFW,MIA,5,26,26,10,29,91
8814,Delta,LAX,DEN,17,9,12,2,15,38
8815,American,ORD,MIA,12,36,41,6,18,101
8816,JetBlue,DFW,MIA,3,8,15,5,9,37
8817,American,JFK,SEA,13,25,34,0,9,68
8818,United,DFW,DEN,20,31,43,7,14,95
8819,Southwest,LAX,PHX,22,27,11,12,13,63
8820,Southwest,LAX,DEN,20,34,4,11,13,62
8821,JetBlue,DFW,SEA,1,43,19,14,4,80
8822,Southwest,LAX,SEA,23,5,35,4,3,47
8823,Delta,DFW,BOS,7,53,46,2,29,130
8824,Delta,LAX,PHX,15,21,46,2,7,76
8825,JetBlue,DFW,BOS,20,18,25,10,1,54
8826,JetBlue,DFW,BOS,14,35,34,12,2,83
8827,Delta,JFK,MIA,5,41,49,9,11,110
8828,American,ORD,BOS,4,15,4,0,8,27
8829,JetBlue,DFW,DEN,11,3,57,12,18,90
8830,United,LAX,SEA,12,55,45,11,17,128
8831,American,JFK,BOS,20,23,19,10,9,61
8832,Southwest,ATL,SEA,17,26,29,1,9,65
8833,Southwest,ORD,BOS,14,0,6,3,25,34
8834,Southwest,JFK,MIA,10,29,51,10,15,105
8835,Delta,ORD,SEA,7,5,13,8,16,42
8836,United,LAX,PHX,20,37,29,11,22,99
8837,United,ORD,MIA,15,17,57,13,20,107
8838,JetBlue,ORD,SEA,19,59,19,8,10,96
8839,JetBlue,ATL,PHX,5,5,38,7,19,69
8840,Delta,ORD,PHX,23,59,40,0,11,110
8841,United,ORD,MIA,18,1,33,1,18,53
8842,JetBlue,LAX,PHX,9,1,30,12,27,70
8843,Delta,JFK,SEA,20,2,43,6,2,53
8844,American,LAX,DEN,13,15,8,7,22,52
8845,JetBlue,ATL,PHX,10,23,10,4,8,45
8846,United,ORD,MIA,22,27,9,14,19,69
8847,American,DFW,BOS,3,28,14,2,17,61
8848,Southwest,DFW,SEA,21,38,21,8,6,73
8849,United,JFK,DEN,12,55,38,4,18,115
8850,JetBlue,ORD,DEN,8,10,24,0,22,56
8851,JetBlue,ORD,PHX,2,28,14,7,11,60
8852,Delta,ORD,PHX,3,21,39,13,0,73
8853,Southwest,LAX,MIA,6,6,43,5,16,70
8854,Delta,JFK,SEA,13,22,37,2,14,75
8855,United,LAX,MIA,3,49,16,3,16,84
8856,United,ATL,DEN,5,57,25,11,8,101
8857,JetBlue,LAX,SEA,3,43,48,14,17,122
8858,United,ATL,DEN,16,8,59,6,9,82
8859,Southwest,JFK,PHX,10,2,34,3,14,53
8860,Southwest,ORD,MIA,16,50,11,10,10,81
8861,American,JFK,DEN,11,33,19,13,29,94
8862,JetBlue,JFK,DEN,6,20,37,5,8,70
8863,United,JFK,BOS,5,11,11,8,12,42
8864,United,ATL,MIA,0,6,3,4,25,38
8865,United,ORD,SEA,22,51,7,1,18,77
8866,JetBlue,LAX,BOS,7,1,26,4,21,52
8867,Delta,DFW,BOS,6,46,20,3,6,75
8868,American,JFK,MIA,12,51,15,8,25,99
8869,JetBlue,ORD,DEN,5,34,0,11,18,63
8870,JetBlue,ORD,MIA,7,36,56,2,28,122
8871,Southwest,LAX,PHX,22,29,10,3,20,62
8872,Southwest,ORD,MIA,21,17,12,6,7,42
8873,Southwest,ATL,BOS,13,44,49,2,12,107
8874,United,ATL,PHX,23,57,43,1,21,122
8875,Delta,ORD,MIA,17,19,56,6,23,104
8876,Delta,ORD,PHX,20,42,4,9,18,73
8877,United,ATL,BOS,16,46,50,6,25,127
8878,Southwest,ATL,MIA,19,4,0,13,3,20
8879,Delta,ORD,MIA,8,17,36,2,8,63
8880,Delta,JFK,MIA,22,1,18,3,19,41
8881,Southwest,ATL,DEN,5,45,56,11,10,122
8882,Delta,JFK,PHX,6,58,25,7,24,114
8883,Southwest,ATL,DEN,8,21,16,8,2,47
8884,American,JFK,SEA,8,11,24,3,6,44
8885,United,DFW,DEN,7,42,8,12,2,64
8886,JetBlue,LAX,SEA,5,54,25,4,29,112
8887,United,JFK,BOS,7,35,50,13,4,102
8888,Southwest,DFW,BOS,2,10,40,14,11,75
8889,Delta,DFW,BOS,6,11,5,10,3,29
8890,Southwest,DFW,SEA,0,11,10,12,0,33
8891,United,ATL,PHX,21,2,32,1,3,38
8892,American,ATL,MIA,1,49,32,11,15,107
8893,United,DFW,BOS,15,46,33,10,9,98
8894,JetBlue,ORD,MIA,10,4,41,4,20,69
8895,Delta,JFK,MIA,7,29,34,3,27,93
8896,JetBlue,ORD,BOS,8,34,45,5,24,108
8897,Southwest,ATL,BOS,21,47,7,0,7,61
8898,American,JFK,MIA,2,5,4,11,3,23
8899,JetBlue,LAX,BOS,23,58,7,5,2,72
8900,JetBlue,LAX,PHX,2,27,47,7,12,93
8901,United,LAX,BOS,2,32,54,5,23,114
8902,Southwest,JFK,PHX,3,32,50,10,23,115
8903,Delta,ATL,BOS,12,5,27,8,16,56
8904,JetBlue,JFK,PHX,6,38,8,5,20,71
8905,American,JFK,SEA,23,39,53,9,25,126
8906,American,LAX,SEA,5,29,51,2,18,100
8907,Delta,ATL,MIA,4,0,1,0,0,1
8908,Delta,ATL,PHX,9,19,38,3,10,70
8909,American,ORD,MIA,18,56,14,8,29,107
8910,Southwest,JFK,SEA,23,27,59,5,5,96
8911,JetBlue,ORD,SEA,9,12,1,3,4,20
8912,JetBlue,DFW,PHX,0,11,38,10,10,69
8913,Delta,ORD,DEN,19,4,35,9,29,77
8914,Delta,JFK,PHX,17,28,36,12,18,94
8915,Southwest,ATL,MIA,13,46,21,4,26,97
8916,United,LAX,PHX,20,18,15,0,0,33
8917,United,DFW,MIA,14,40,37,1,29,107
8918,JetBlue,ORD,SEA,22,48,10,9,9,76
8919,JetBlue,ORD,PHX,10,1,41,2,3,47
8920,United,ORD,MIA,3,22,29,10,28,89
8921,United,LAX,DEN,20,49,6,8,12,75
8922,Southwest,JFK,MIA,18,2,24,1,14,41
8923,JetBlue,JFK,DEN,20,53,36,2,19,110
8924,American,ORD,PHX,0,46,42,7,6,101
8925,Delta,DFW,PHX,23,28,14,12,15,69
8926,American,ATL,MIA,19,57,8,11,29,105
8927,Delta,ATL,DEN,1,0,47,7,15,69
8928,American,DFW,PHX,13,50,57,11,6,124
8929,American,DFW,DEN,12,28,5,11,8,52
8930,Delta,ATL,SEA,20,57,15,13,3,88
8931,American,LAX,BOS,8,16,40,4,1,61
8932,Southwest,LAX,DEN,17,52,50,7,4,113
8933,United,ORD,DEN,23,34,9,0,27,70
8934,United,DFW,PHX,4,12,45,6,24,87
8935,American,DFW,PHX,8,46,9,4,22,81
8936,United,LAX,PHX,12,26,6,1,21,54
8937,Southwest,ORD,DEN,3,7,44,14,29,94
8938,American,ATL,MIA,12,25,27,2,9,63
8939,United,ORD,PHX,4,59,7,4,8,78
8940,American,ORD,PHX,20,23,7,7,8,45
8941,Southwest,DFW,MIA,22,14,24,14,11,63
8942,Delta,JFK,DEN,19,6,17,8,29,60
8943,JetBlue,JFK,SEA,23,3,25,2,7,37
8944,JetBlue,LAX,PHX,4,10,20,14,28,72
8945,United,ORD,MIA,12,24,35,1,12,72
8946,Delta,LAX,PHX,10,5,22,1,11,39
8947,American,LAX,DEN,16,52,11,3,22,88
8948,JetBlue,ATL,DEN,3,45,16,2,8,71
8949,American,LAX,PHX,4,27,42,14,25,108
8950,Southwest,ATL,DEN,21,45,36,14,1,96
8951,American,ORD,PHX,10,22,1,7,6,36
8952,Southwest,ATL,PHX,8,28,13,3,5,49
8953,JetBlue,ATL,SEA,1,54,57,4,3,118
8954,Southwest,ATL,DEN,8,29,13,10,14,66
8955,Delta,ORD,BOS,14,16,49,7,10,82
8956,Delta,ORD,MIA,15,1,10,8,14,33
8957,American,ATL,DEN,11,4,46,14,20,84
8958,Delta,DFW,SEA,14,52,57,10,22,141
8959,JetBlue,LAX,BOS,11,9,13,10,20,52
8960,American,ORD,MIA,22,20,42,9,14,85
8961,United,JFK,DEN,5,23,13,12,18,66
8962,Delta,LAX,DEN,5,25,1,10,25,61
8963,Southwest,ATL,PHX,0,3,31,6,27,67
8964,Southwest,ORD,BOS,13,50,24,9,20,103
8965,JetBlue,ORD,DEN,21,38,45,5,5,93
8966,Delta,JFK,BOS,17,23,1,8,12,44
8967,Southwest,ORD,BOS,23,44,1,14,20,79
8968,Delta,LAX,MIA,0,28,34,12,3,77
8969,American,ATL,SEA,22,39,13,11,15,78
8970,Southwest,LAX,BOS,13,51,59,13,2,125
8971,United,JFK,BOS,19,29,46,14,7,96
8972,Southwest,ATL,MIA,10,12,11,10,22,55
8973,Delta,ATL,MIA,16,6,59,13,28,106
8974,Delta,LAX,DEN,18,36,31,5,20,92
8975,JetBlue,JFK,BOS,13,9,52,7,21,89
8976,American,LAX,SEA,15,3,53,11,29,96
8977,JetBlue,ATL,BOS,10,2,49,5,17,73
8978,United,ATL,BOS,4,19,36,3,3,61
8979,Southwest,JFK,BOS,17,19,40,11,23,93
8980,JetBlue,ORD,SEA,14,7,46,4,5,62
8981,Southwest,DFW,DEN,0,23,23,12,5,63
8982,Southwest,JFK,PHX,22,18,26,7,14,65
8983,American,LAX,DEN,4,14,24,10,17,65
8984,American,LAX,MIA,17,23,4,7,5,39
8985,United,ORD,PHX,0,32,55,11,23,121
8986,United,DFW,DEN,13,26,22,11,17,76
8987,JetBlue,LAX,PHX,20,46,54,5,1,106
8988,American,DFW,PHX,7,41,53,5,13,112
8989,Delta,DFW,DEN,19,37,33,7,7,84
8990,American,LAX,BOS,22,31,44,0,4,79
8991,United,JFK,MIA,8,37,46,4,18,105
8992,Delta,LAX,BOS,10,7,10,1,28,46
8993,Delta,LAX,DEN,15,22,6,10,10,48
8994,JetBlue,ATL,BOS,9,1,7,8,28,44
8995,United,ATL,MIA,2,49,48,8,7,112
8996,United,JFK,MIA,12,26,4,7,26,63
8997,American,LAX,SEA,20,27,28,7,17,79
8998,American,ATL,MIA,7,2,35,12,17,66
8999,Southwest,DFW,DEN,13,35,50,14,18,117
9000,United,JFK,SEA,22,30,17,2,26,75
9001,JetBlue,LAX,SEA,7,14,27,3,13,57
9002,Southwest,JFK,SEA,4,39,11,8,19,77
9003,United,JFK,SEA,18,33,35,13,6,87
9004,JetBlue,JFK,PHX,17,18,22,13,1,54
9005,American,DFW,MIA,12,51,14,11,0,76
9006,Southwest,DFW,DEN,12,1,43,1,9,54
9007,Delta,JFK,MIA,10,19,15,3,2,39
9008,Delta,ATL,MIA,21,39,26,2,7,74
9009,American,JFK,MIA,7,32,5,1,8,46
9010,Delta,JFK,PHX,2,17,8,1,29,55
9011,JetBlue,ATL,MIA,9,35,40,10,20,105
9012,United,JFK,MIA,12,5,49,2,13,69
9013,United,DFW,BOS,20,35,33,3,6,77
9014,Delta,ATL,BOS,22,4,29,14,19,66
9015,United,ORD,MIA,21,17,12,0,2,31
9016,JetBlue,JFK,BOS,11,32,52,10,9,103
9017,Southwest,ATL,SEA,15,25,4,1,18,48
9018,JetBlue,LAX,PHX,6,17,38,2,8,65
9019,American,LAX,DEN,6,57,15,0,17,89
9020,Southwest,LAX,MIA,10,32,43,8,20,103
9021,United,ATL,MIA,10,16,44,13,18,91
9022,United,DFW,SEA,18,33,6,8,26,73
9023,Southwest,LAX,MIA,9,32,24,8,6,70
9024,Southwest,ORD,PHX,16,44,21,1,18,84
9025,JetBlue,LAX,DEN,19,32,34,2,11,79
9026,Delta,ORD,BOS,14,46,20,6,24,96
9027,Southwest,DFW,BOS,5,55,24,14,23,116
9028,American,DFW,BOS,16,49,19,9,6,83
9029,American,DFW,SEA,13,49,44,9,18,120
9030,Southwest,ATL,DEN,17,1,52,0,3,56
9031,Southwest,DFW,DEN,7,36,38,7,18,99
9032,United,DFW,SEA,2,29,34,3,4,70
9033,JetBlue,DFW,PHX,14,23,19,10,0,52
9034,Southwest,ATL,SEA,18,39,7,6,22,74
9035,Delta,ATL,PHX,15,4,9,9,28,50
9036,Southwest,ATL,DEN,7,16,47,10,2,75
9037,American,JFK,PHX,0,3,16,6,3,28
9038,United,ORD,BOS,8,2,13,3,12,30
9039,Delta,LAX,MIA,11,41,25,9,20,95
9040,JetBlue,ORD,PHX,20,57,27,14,18,116
9041,JetBlue,ORD,SEA,2,34,24,9,6,73
9042,JetBlue,DFW,PHX,8,13,55,5,23,96
9043,JetBlue,JFK,BOS,16,51,49,14,29,143
9044,United,LAX,SEA,21,7,30,2,4,43
9045,JetBlue,LAX,MIA,4,24,20,11,14,69
9046,Delta,DFW,BOS,19,41,1,4,26,72
9047,JetBlue,ATL,DEN,10,0,5,6,1,12
9048,Southwest,ATL,SEA,7,19,13,3,15,50
9049,Delta,JFK,MIA,1,29,14,8,15,66
9050,Delta,ATL,SEA,2,9,13,7,16,45
9051,United,ATL,DEN,15,8,6,14,22,50
9052,United,ATL,MIA,4,20,28,9,12,69
9053,American,ATL,MIA,7,19,16,11,22,68
9054,United,ORD,BOS,10,51,39,12,18,120
9055,JetBlue,ATL,DEN,12,21,31,1,19,72
9056,American,DFW,PHX,15,9,27,0,16,52
9057,Southwest,JFK,MIA,12,15,15,14,1,45
9058,Delta,ATL,PHX,9,59,41,4,16,120
9059,JetBlue,ATL,BOS,21,36,16,4,16,72
9060,American,ATL,SEA,9,16,43,0,2,61
9061,Southwest,ATL,BOS,9,56,29,8,3,96
9062,JetBlue,ORD,PHX,13,28,39,0,10,77
9063,Delta,JFK,MIA,19,37,1,12,24,74
9064,American,JFK,DEN,4,38,33,2,17,90
9065,Delta,JFK,BOS,8,44,29,1,20,94
9066,Delta,DFW,DEN,14,24,31,12,22,89
9067,United,DFW,DEN,18,43,29,10,19,101
9068,Southwest,JFK,MIA,21,29,36,14,5,84
9069,Delta,ATL,MIA,17,19,7,0,27,53
9070,Southwest,DFW,BOS,13,4,43,10,17,74
9071,American,ORD,PHX,16,43,34,1,15,93
9072,JetBlue,DFW,SEA,8,11,59,9,11,90
9073,American,ORD,BOS,0,41,8,4,26,79
9074,Southwest,DFW,MIA,21,5,54,6,9,74
9075,Delta,LAX,MIA,18,51,5,0,11,67
9076,United,DFW,DEN,17,53,54,3,15,125
9077,United,JFK,MIA,6,42,54,3,10,109
9078,Southwest,JFK,DEN,0,19,23,14,29,85
9079,Southwest,ORD,MIA,8,21,17,4,22,64
9080,American,DFW,MIA,23,10,0,5,12,27
9081,United,DFW,DEN,10,49,27,12,10,98
9082,JetBlue,JFK,DEN,16,0,48,7,26,81
9083,United,ATL,SEA,22,43,9,5,1,58
9084,JetBlue,LAX,SEA,20,54,4,7,7,72
9085,United,DFW,DEN,17,24,55,13,11,103
9086,Southwest,LAX,PHX,6,33,11,11,11,66
9087,American,DFW,PHX,1,10,26,6,18,60
9088,American,JFK,MIA,6,47,53,7,14,121
9089,JetBlue,DFW,SEA,20,57,20,1,17,95
9090,Delta,DFW,PHX,19,39,17,12,18,86
9091,Southwest,LAX,BOS,14,55,20,0,15,90
9092,JetBlue,ATL,PHX,10,4,31,0,28,63
9093,Delta,LAX,BOS,17,52,39,4,9,104
9094,JetBlue,DFW,SEA,3,7,43,6,11,67
9095,United,ATL,MIA,22,15,16,11,2,44
9096,Southwest,LAX,DEN,15,36,39,3,19,97
9097,JetBlue,DFW,MIA,21,14,25,3,27,69
9098,Southwest,DFW,PHX,15,43,43,6,2,94
9099,Southwest,ORD,BOS,11,5,52,5,16,78
9100,American,DFW,BOS,18,46,29,4,0,79
9101,American,DFW,BOS,1,28,27,14,8,77
9102,American,ORD,PHX,0,50,6,12,5,73
9103,JetBlue,JFK,PHX,22,32,21,7,21,81
9104,JetBlue,ATL,BOS,10,15,15,8,26,64
9105,American,DFW,DEN,22,55,8,8,21,92
9106,American,LAX,DEN,2,44,22,11,2,79
9107,American,ORD,PHX,7,38,30,8,9,85
9108,Delta,LAX,PHX,10,0,52,2,25,79
9109,JetBlue,DFW,BOS,20,26,52,0,5,83
9110,Delta,LAX,MIA,0,5,8,2,16,31
9111,United,ORD,SEA,11,11,39,1,26,77
9112,Southwest,ORD,MIA,9,12,22,0,5,39
9113,Delta,ORD,PHX,20,10,52,1,22,85
9114,Delta,DFW,DEN,13,40,32,10,16,98
9115,American,ORD,SEA,20,24,50,13,29,116
9116,Southwest,JFK,SEA,6,55,47,7,29,138
9117,Delta,JFK,BOS,4,16,1,14,5,36
9118,JetBlue,ORD,SEA,19,58,0,5,28,91
9119,American,LAX,BOS,4,23,56,3,11,93
9120,Southwest,DFW,PHX,4,9,30,2,10,51
9121,JetBlue,ATL,DEN,23,7,18,2,21,48
9122,Delta,ATL,MIA,0,24,20,3,28,75
9123,Southwest,ORD,SEA,17,28,36,1,10,75
9124,Delta,ORD,BOS,20,7,49,1,16,73
9125,Delta,LAX,DEN,12,20,17,4,15,56
9126,United,JFK,BOS,0,29,54,7,28,118
9127,American,JFK,PHX,19,57,55,13,4,129
9128,American,ORD,SEA,18,13,5,2,21,41
9129,American,ORD,DEN,20,33,54,14,2,103
9130,Delta,ATL,DEN,21,36,4,5,8,53
9131,Southwest,ORD,MIA,20,19,28,1,25,73
9132,JetBlue,ORD,DEN,5,22,21,14,24,81
9133,Delta,DFW,SEA,14,56,45,1,14,116
9134,United,ORD,SEA,11,5,8,12,19,44
9135,Southwest,DFW,BOS,16,28,40,1,14,83
9136,American,LAX,BOS,3,22,32,10,19,83
9137,United,ATL,DEN,10,28,57,7,10,102
9138,Delta,JFK,SEA,22,13,7,14,9,43
9139,United,JFK,MIA,5,59,50,7,3,119
9140,United,LAX,DEN,18,5,15,5,11,36
9141,Delta,DFW,PHX,22,57,16,14,18,105
9142,Southwest,LAX,SEA,22,44,28,13,2,87
9143,Southwest,ORD,SEA,8,21,46,6,18,91
9144,Southwest,DFW,BOS,14,47,18,7,2,74
9145,American,DFW,SEA,0,47,11,12,11,81
9146,Delta,LAX,PHX,0,42,15,12,13,82
9147,JetBlue,ATL,SEA,20,18,51,8,21,98
9148,United,ATL,PHX,21,4,27,13,11,55
9149,United,LAX,SEA,14,20,44,6,15,85
9150,United,ORD,BOS,12,37,50,2,12,101
9151,United,JFK,PHX,0,31,42,4,22,99
9152,United,JFK,SEA,3,14,7,14,0,35
9153,Southwest,DFW,MIA,23,57,12,8,22,99
9154,Delta,DFW,SEA,12,21,43,7,17,88
9155,Southwest,JFK,SEA,11,16,5,5,5,31
9156,American,JFK,DEN,19,34,42,2,20,98
9157,United,ATL,DEN,0,25,12,2,18,57
9158,Delta,DFW,PHX,22,17,17,2,10,46
9159,Delta,LAX,DEN,4,48,20,11,0,79
9160,Southwest,ATL,BOS,2,44,43,7,10,104
9161,Delta,LAX,SEA,8,3,36,7,4,50
9162,JetBlue,DFW,BOS,5,44,36,2,12,94
9163,United,ORD,MIA,4,42,59,14,10,125
9164,Southwest,JFK,MIA,6,26,31,0,23,80
9165,United,ORD,SEA,10,29,14,4,7,54
9166,JetBlue,ORD,SEA,21,10,11,14,4,39
9167,JetBlue,ORD,BOS,19,54,49,8,17,128
9168,American,ATL,MIA,17,56,58,13,12,139
9169,Southwest,DFW,DEN,6,14,27,12,25,78
9170,Southwest,DFW,SEA,0,38,51,4,23,116
9171,American,ORD,BOS,21,15,30,5,18,68
9172,United,DFW,SEA,13,34,44,3,11,92
9173,United,LAX,DEN,11,50,30,13,3,96
9174,American,LAX,PHX,8,26,16,8,20,70
9175,Delta,JFK,SEA,16,52,53,2,1,108
9176,American,DFW,DEN,3,22,36,2,26,86
9177,JetBlue,JFK,PHX,17,5,20,1,10,36
9178,Delta,DFW,MIA,7,16,6,7,26,55
9179,United,JFK,DEN,1,26,6,9,27,68
9180,JetBlue,ATL,BOS,17,21,31,9,14,75
9181,Delta,DFW,PHX,20,19,1,10,27,57
9182,United,JFK,SEA,23,17,49,7,18,91
9183,Delta,JFK,BOS,9,33,58,0,23,114
9184,JetBlue,ORD,BOS,8,59,18,6,0,83
9185,JetBlue,ATL,MIA,20,29,46,12,14,101
9186,Southwest,ATL,PHX,16,31,7,2,8,48
9187,American,JFK,MIA,14,49,48,4,11,112
9188,United,ATL,PHX,22,45,15,0,18,78
9189,United,ATL,BOS,16,50,27,1,18,96
9190,Southwest,DFW,BOS,8,50,34,10,8,102
9191,Delta,ORD,DEN,4,32,31,3,3,69
9192,American,JFK,BOS,18,6,8,14,2,30
9193,Delta,ORD,MIA,9,55,9,6,18,88
9194,Delta,ORD,BOS,21,31,49,13,14,107
9195,JetBlue,ORD,MIA,18,45,0,9,8,62
9196,Southwest,ATL,BOS,13,44,6,10,5,65
9197,Delta,DFW,DEN,8,5,19,11,25,60
9198,Southwest,ATL,SEA,7,27,19,3,13,62
9199,Southwest,ATL,DEN,1,55,33,2,0,90
9200,Southwest,JFK,BOS,14,32,19,11,12,74
9201,United,JFK,PHX,20,5,41,14,11,71
9202,Southwest,DFW,BOS,2,53,9,11,21,94
9203,United,ATL,DEN,0,30,4,2,9,45
9204,Southwest,DFW,DEN,23,42,0,6,4,52
9205,American,LAX,BOS,5,30,34,6,7,77
9206,Delta,LAX,SEA,3,15,11,1,25,52
9207,Southwest,LAX,DEN,11,39,52,3,29,123
9208,JetBlue,ATL,MIA,9,12,41,11,12,76
9209,United,ATL,MIA,3,34,42,9,0,85
9210,Southwest,ORD,SEA,13,52,7,7,12,78
9211,Southwest,ATL,DEN,9,3,51,11,14,79
9212,American,LAX,SEA,18,42,22,0,28,92
9213,United,JFK,BOS,2,58,51,12,2,123
9214,United,ATL,PHX,16,57,49,6,23,135
9215,JetBlue,ATL,PHX,3,35,5,9,25,74
9216,American,JFK,DEN,9,53,9,4,10,76
9217,United,JFK,BOS,21,8,58,13,8,87
9218,Delta,JFK,DEN,4,33,36,3,3,75
9219,United,DFW,PHX,21,36,21,0,12,69
9220,JetBlue,ORD,BOS,20,44,43,9,28,124
9221,JetBlue,ORD,SEA,17,51,53,2,14,120
9222,JetBlue,ATL,BOS,15,5,25,8,27,65
9223,United,JFK,SEA,10,47,36,10,28,121
9224,United,DFW,SEA,3,27,19,5,29,80
9225,Southwest,ORD,SEA,0,35,14,1,1,51
9226,Southwest,DFW,PHX,4,37,8,5,27,77
9227,United,JFK,MIA,15,55,9,13,15,92
9228,American,ORD,MIA,3,36,34,12,1,83
9229,United,ORD,MIA,15,48,49,12,21,130
9230,JetBlue,ATL,MIA,15,58,8,7,20,93
9231,United,DFW,SEA,10,45,8,5,4,62
9232,American,DFW,BOS,6,5,20,10,12,47
9233,American,LAX,SEA,13,19,20,4,2,45
9234,Delta,JFK,PHX,7,23,23,0,20,66
9235,American,LAX,MIA,3,0,7,11,15,33
9236,United,DFW,SEA,20,52,16,9,9,86
9237,JetBlue,ATL,DEN,19,23,11,12,4,50
9238,Southwest,LAX,BOS,3,6,40,11,18,75
9239,Southwest,DFW,MIA,10,57,34,9,8,108
9240,Southwest,ATL,BOS,5,43,4,12,27,86
9241,Delta,ORD,MIA,18,17,27,10,4,58
9242,American,ORD,DEN,10,56,8,12,8,84
9243,United,DFW,MIA,18,27,39,11,18,95
9244,Delta,ORD,DEN,13,49,59,7,29,144
9245,American,JFK,DEN,16,26,45,4,4,79
9246,American,DFW,SEA,12,54,2,9,5,70
9247,American,JFK,PHX,22,52,46,12,4,114
9248,JetBlue,JFK,DEN,21,36,14,7,16,73
9249,JetBlue,DFW,DEN,4,7,48,8,29,92
9250,Southwest,ORD,MIA,7,37,58,8,4,107
9251,Delta,JFK,BOS,1,48,4,14,3,69
9252,American,JFK,BOS,15,3,50,0,25,78
9253,JetBlue,ATL,MIA,12,36,45,0,12,93
9254,American,DFW,SEA,5,14,11,9,17,51
9255,Delta,LAX,PHX,12,37,11,11,24,83
9256,JetBlue,ORD,PHX,13,17,32,6,28,83
9257,Delta,JFK,MIA,0,43,22,3,14,82
9258,Delta,LAX,DEN,4,57,34,6,18,115
9259,Southwest,ORD,MIA,13,15,37,2,4,58
9260,Delta,LAX,BOS,15,20,32,3,15,70
9261,JetBlue,ORD,DEN,15,1,19,8,23,51
9262,American,ORD,SEA,3,17,43,5,6,71
9263,United,ATL,MIA,0,58,50,11,14,133
9264,JetBlue,LAX,DEN,8,55,18,5,19,97
9265,United,ATL,MIA,21,57,22,9,0,88
9266,Delta,LAX,BOS,4,42,56,0,19,117
9267,JetBlue,JFK,PHX,10,1,14,1,17,33
9268,JetBlue,ORD,MIA,11,31,58,3,24,116
9269,Delta,LAX,PHX,6,2,0,7,29,38
9270,American,ORD,MIA,23,43,47,9,17,116
9271,American,DFW,MIA,15,8,50,12,11,81
9272,United,JFK,DEN,9,23,7,1,17,48
9273,United,JFK,MIA,0,23,57,9,9,98
9274,Southwest,ATL,SEA,0,1,32,3,24,60
9275,Southwest,LAX,BOS,3,23,40,10,15,88
9276,Delta,ATL,SEA,15,39,53,12,6,110
9277,Southwest,JFK,BOS,10,49,30,2,22,103
9278,JetBlue,JFK,BOS,16,3,35,0,18,56
9279,JetBlue,ORD,MIA,13,42,32,1,8,83
9280,American,JFK,DEN,9,0,46,6,16,68
9281,American,ATL,MIA,8,33,17,3,20,73
9282,American,JFK,PHX,16,36,6,9,15,66
9283,American,LAX,SEA,2,21,16,6,22,65
9284,Delta,ORD,SEA,4,1,52,11,26,90
9285,JetBlue,DFW,PHX,4,55,30,12,7,104
9286,United,ORD,DEN,15,41,21,6,2,70
9287,Southwest,ORD,MIA,15,49,4,14,29,96
9288,American,ORD,BOS,4,2,1,11,8,22
9289,Southwest,DFW,MIA,18,54,12,2,23,91
9290,American,LAX,DEN,6,27,50,4,7,88
9291,Delta,ATL,PHX,4,0,35,10,2,47
9292,American,DFW,DEN,1,59,59,12,26,156
9293,JetBlue,DFW,SEA,6,27,15,11,1,54
9294,United,JFK,DEN,7,49,31,13,3,96
9295,Southwest,ORD,SEA,5,45,11,8,25,89
9296,JetBlue,JFK,PHX,17,57,40,14,26,137
9297,JetBlue,ORD,PHX,9,9,44,8,24,85
9298,United,LAX,BOS,18,38,27,3,16,84
9299,JetBlue,DFW,SEA,2,40,58,8,27,133
9300,Delta,ORD,BOS,16,2,32,8,4,46
9301,American,ORD,MIA,10,7,6,2,12,27
9302,JetBlue,ATL,MIA,5,51,41,8,8,108
9303,JetBlue,LAX,SEA,7,51,34,0,17,102
9304,Southwest,ATL,BOS,13,55,39,3,24,121
9305,Southwest,ORD,BOS,10,24,36,11,13,84
9306,United,ATL,DEN,4,43,18,9,12,82
9307,JetBlue,JFK,BOS,17,1,33,11,18,63
9308,Southwest,DFW,MIA,7,25,52,13,28,118
9309,American,DFW,MIA,12,0,15,10,23,48
9310,Southwest,LAX,PHX,5,41,44,2,6,93
9311,Southwest,LAX,DEN,8,45,5,4,9,63
9312,American,ORD,DEN,21,14,19,4,21,58
9313,Southwest,DFW,MIA,21,22,7,11,25,65
9314,JetBlue,LAX,SEA,10,49,54,7,15,125
9315,American,ORD,PHX,0,20,46,6,24,96
9316,JetBlue,ORD,DEN,22,12,21,1,15,49
9317,Southwest,DFW,DEN,1,32,37,0,28,97
9318,Delta,JFK,SEA,7,31,19,14,9,73
9319,Southwest,ORD,MIA,0,11,15,13,5,44
9320,United,JFK,MIA,11,13,37,9,19,78
9321,JetBlue,DFW,PHX,17,54,18,7,5,84
9322,American,DFW,MIA,14,48,44,2,25,119
9323,American,DFW,MIA,17,2,51,0,10,63
9324,American,DFW,MIA,2,15,41,6,29,91
9325,Delta,DFW,MIA,19,51,47,11,2,111
9326,American,JFK,MIA,19,6,27,7,25,65
9327,American,LAX,DEN,16,16,58,9,17,100
9328,Southwest,JFK,BOS,3,39,24,5,23,91
9329,United,ATL,MIA,15,6,18,9,25,58
9330,United,DFW,BOS,11,35,19,7,23,84
9331,JetBlue,ORD,MIA,8,37,37,5,22,101
9332,American,ORD,DEN,12,51,5,1,4,61
9333,Southwest,JFK,SEA,2,20,56,11,24,111
9334,JetBlue,JFK,BOS,13,34,14,11,19,78
9335,American,DFW,PHX,23,18,27,4,3,52
9336,United,JFK,BOS,18,51,6,7,14,78
9337,American,JFK,MIA,7,7,31,8,11,57
9338,Southwest,ORD,DEN,20,16,40,12,11,79
9339,United,ORD,DEN,21,10,24,8,29,71
9340,United,ORD,BOS,20,23,3,0,18,44
9341,Delta,LAX,BOS,9,59,34,9,27,129
9342,American,ORD,BOS,18,19,30,8,24,81
9343,United,DFW,PHX,18,8,39,5,14,66
9344,JetBlue,ATL,MIA,1,27,3,12,29,71
9345,Delta,JFK,MIA,11,5,44,7,1,57
9346,JetBlue,JFK,PHX,20,36,48,3,1,88
9347,JetBlue,JFK,DEN,6,59,53,10,12,134
9348,Southwest,ATL,PHX,21,50,12,9,16,87
9349,Delta,JFK,MIA,0,21,0,4,23,48
9350,Southwest,ATL,SEA,6,39,43,8,9,99
9351,American,DFW,MIA,1,23,12,3,0,38
9352,Southwest,LAX,MIA,22,53,56,3,15,127
9353,American,JFK,BOS,4,38,40,2,17,97
9354,Delta,ATL,PHX,7,51,37,7,0,95
9355,Delta,LAX,BOS,1,4,20,3,25,52
9356,United,JFK,DEN,17,35,53,12,10,110
9357,JetBlue,ORD,MIA,21,30,37,13,2,82
9358,American,JFK,BOS,17,26,5,4,0,35
9359,American,JFK,BOS,10,7,37,10,21,75
9360,Delta,ATL,DEN,21,17,40,1,3,61
9361,Southwest,LAX,PHX,7,11,57,1,17,86
9362,United,ORD,SEA,20,36,58,3,24,121
9363,United,ATL,PHX,17,9,2,10,27,48
9364,Southwest,ORD,BOS,8,51,44,7,5,107
9365,American,JFK,BOS,10,23,35,5,9,72
9366,United,ATL,DEN,3,42,1,8,29,80
9367,United,ORD,BOS,17,55,51,11,4,121
9368,JetBlue,ATL,MIA,11,21,54,13,12,100
9369,United,DFW,PHX,13,26,54,10,3,93
9370,JetBlue,DFW,SEA,20,16,8,12,7,43
9371,Delta,DFW,MIA,11,42,59,0,8,109
9372,United,ATL,BOS,18,7,3,6,24,40
9373,American,ORD,PHX,16,17,49,3,16,85
9374,United,ORD,BOS,4,17,23,5,17,62
9375,American,LAX,SEA,14,17,21,5,0,43
9376,Southwest,ATL,MIA,21,5,18,8,22,53
9377,American,LAX,SEA,16,27,20,12,5,64
9378,Southwest,LAX,MIA,3,32,14,11,1,58
9379,Southwest,DFW,MIA,9,38,16,1,27,82
9380,JetBlue,JFK,MIA,4,43,2,3,4,52
9381,Southwest,JFK,DEN,16,14,28,8,14,64
9382,Delta,DFW,DEN,1,58,21,1,29,109
9383,JetBlue,LAX,PHX,1,45,9,3,1,58
9384,Delta,DFW,PHX,5,27,43,2,15,87
9385,Delta,DFW,DEN,8,2,48,10,12,72
9386,United,JFK,SEA,22,57,16,6,15,94
9387,Delta,DFW,DEN,8,31,16,6,21,74
9388,JetBlue,ATL,PHX,17,7,33,10,17,67
9389,Delta,DFW,SEA,15,0,46,7,8,61
9390,JetBlue,LAX,BOS,13,9,41,1,8,59
9391,Southwest,ATL,BOS,11,36,21,13,17,87
9392,Southwest,ORD,DEN,2,16,4,3,24,47
9393,American,ATL,PHX,20,22,4,2,5,33
9394,Delta,JFK,SEA,3,57,19,0,29,105
9395,Delta,ORD,DEN,11,28,5,4,1,38
9396,Southwest,ORD,PHX,11,35,50,3,1,89
9397,Southwest,JFK,PHX,10,45,49,8,27,129
9398,United,DFW,MIA,12,10,45,4,0,59
9399,American,LAX,MIA,8,44,19,3,7,73
9400,American,ORD,MIA,7,47,19,0,26,92
9401,American,DFW,PHX,17,32,14,1,26,73
9402,JetBlue,DFW,DEN,9,29,48,2,15,94
9403,Southwest,DFW,MIA,15,24,19,14,9,66
9404,United,ORD,BOS,2,56,27,3,25,111
9405,JetBlue,JFK,BOS,9,34,47,12,17,110
9406,American,ATL,MIA,1,52,43,1,27,123
9407,Delta,ATL,MIA,7,28,39,1,7,75
9408,Delta,DFW,SEA,6,39,34,6,28,107
9409,American,LAX,BOS,23,6,45,1,2,54
9410,American,ORD,PHX,20,47,34,3,25,109
9411,Delta,DFW,BOS,17,9,18,3,23,53
9412,JetBlue,DFW,SEA,8,33,55,12,19,119
9413,American,LAX,BOS,5,47,26,1,22,96
9414,United,JFK,SEA,15,31,18,4,19,72
9415,Southwest,LAX,DEN,17,59,59,4,16,138
9416,United,ORD,BOS,2,14,23,13,26,76
9417,Delta,ATL,MIA,22,5,21,0,27,53
9418,JetBlue,ATL,PHX,0,33,3,11,0,47
9419,Southwest,ATL,PHX,6,31,44,14,14,103
9420,JetBlue,ATL,PHX,21,57,2,0,17,76
9421,American,ORD,DEN,19,19,12,10,26,67
9422,Delta,DFW,BOS,18,28,49,8,4,89
9423,Southwest,DFW,PHX,17,7,29,11,29,76
9424,JetBlue,ATL,BOS,14,10,30,12,28,80
9425,American,DFW,PHX,5,29,31,13,12,85
9426,American,ATL,MIA,3,13,30,12,17,72
9427,Delta,ORD,BOS,0,17,3,10,5,35
9428,JetBlue,DFW,DEN,4,10,5,9,25,49
9429,United,ORD,MIA,4,51,38,14,21,124
9430,JetBlue,JFK,SEA,10,0,2,7,25,34
9431,Delta,ATL,DEN,8,31,9,0,12,52
9432,Southwest,JFK,SEA,12,10,53,5,0,68
9433,Delta,LAX,PHX,2,13,53,1,12,79
9434,JetBlue,LAX,MIA,21,33,26,5,24,88
9435,JetBlue,DFW,PHX,14,3,6,7,10,26
9436,Southwest,ATL,DEN,9,37,53,4,2,96
9437,American,ATL,MIA,2,15,38,0,19,72
9438,United,ATL,BOS,13,49,17,10,20,96
9439,American,LAX,BOS,23,9,17,4,0,30
9440,JetBlue,ATL,PHX,7,50,11,1,23,85
9441,Delta,ATL,PHX,9,34,52,7,26,119
9442,JetBlue,JFK,PHX,6,49,30,4,14,97
9443,JetBlue,JFK,SEA,6,22,55,12,8,97
9444,United,ORD,PHX,19,33,17,4,0,54
9445,Southwest,LAX,PHX,7,30,56,10,11,107
9446,Delta,ORD,MIA,12,32,45,4,9,90
9447,United,JFK,PHX,2,51,7,3,16,77
9448,United,JFK,BOS,18,13,30,10,29,82
9449,JetBlue,JFK,SEA,11,20,19,10,10,59
9450,Southwest,LAX,SEA,11,43,25,6,19,93
9451,Delta,JFK,BOS,21,22,2,11,17,52
9452,United,ORD,BOS,20,58,25,8,27,118
9453,JetBlue,JFK,BOS,9,5,24,6,27,62
9454,JetBlue,LAX,MIA,0,38,49,3,27,117
9455,United,ATL,BOS,19,14,4,11,27,56
9456,JetBlue,ORD,DEN,18,38,56,4,26,124
9457,Delta,LAX,MIA,5,57,45,11,1,114
9458,JetBlue,ATL,DEN,2,49,33,11,6,99
9459,American,ORD,MIA,15,25,56,12,13,106
9460,JetBlue,LAX,PHX,18,47,35,2,8,92
9461,JetBlue,ORD,DEN,23,29,58,8,7,102
9462,United,DFW,SEA,7,16,37,7,1,61
9463,JetBlue,DFW,DEN,17,38,3,14,17,72
9464,Southwest,DFW,MIA,6,47,54,13,18,132
9465,JetBlue,ORD,PHX,10,43,56,12,16,127
9466,Delta,ATL,DEN,21,51,31,6,23,111
9467,American,LAX,DEN,12,52,36,0,23,111
9468,American,ATL,DEN,14,45,51,3,22,121
9469,JetBlue,ATL,PHX,10,18,59,8,1,86
9470,Southwest,ATL,BOS,23,44,20,13,4,81
9471,Southwest,ORD,BOS,14,27,15,10,22,74
9472,American,DFW,BOS,12,12,36,9,1,58
9473,United,JFK,PHX,8,24,17,10,3,54
9474,United,ATL,SEA,0,57,20,7,26,110
9475,Southwest,ORD,BOS,4,44,22,0,23,89
9476,Delta,DFW,MIA,23,26,22,9,15,72
9477,United,JFK,SEA,21,32,56,2,21,111
9478,JetBlue,JFK,MIA,18,24,52,8,20,104
9479,United,ATL,PHX,15,28,28,1,8,65
9480,American,DFW,SEA,10,26,29,7,4,66
9481,JetBlue,JFK,SEA,2,50,29,4,4,87
9482,United,ORD,DEN,21,23,32,10,24,89
9483,Delta,JFK,SEA,0,35,6,11,8,60
9484,American,JFK,DEN,3,43,28,9,14,94
9485,United,JFK,DEN,23,50,37,14,8,109
9486,Delta,DFW,BOS,4,36,32,0,12,80
9487,Southwest,DFW,PHX,12,40,17,12,2,71
9488,Delta,ORD,DEN,6,53,21,3,5,82
9489,Southwest,ORD,MIA,20,39,8,11,0,58
9490,American,JFK,BOS,18,3,54,8,14,79
9491,American,DFW,DEN,19,27,46,10,7,90
9492,American,JFK,SEA,3,52,14,8,3,77
9493,JetBlue,JFK,MIA,12,14,29,14,20,77
9494,Southwest,LAX,BOS,16,18,56,6,4,84
9495,JetBlue,ATL,DEN,3,38,32,14,5,89
9496,American,LAX,SEA,20,10,30,11,17,68
9497,Delta,ORD,DEN,6,13,8,13,26,60
9498,Delta,DFW,DEN,8,37,20,1,15,73
9499,United,ORD,MIA,20,58,29,6,20,113
9500,United,LAX,PHX,3,55,47,14,10,126
9501,American,ORD,PHX,7,49,56,1,2,108
9502,Delta,DFW,PHX,3,34,17,4,0,55
9503,JetBlue,ORD,PHX,17,9,13,4,19,45
9504,American,ORD,BOS,5,33,56,6,17,112
9505,Delta,ATL,DEN,0,14,54,4,14,86
9506,United,ATL,MIA,22,40,45,0,12,97
9507,JetBlue,ATL,BOS,8,10,19,12,27,68
9508,Delta,ORD,DEN,11,46,0,6,22,74
9509,United,ORD,DEN,4,24,5,6,13,48
9510,Southwest,LAX,MIA,4,2,26,11,19,58
9511,United,DFW,BOS,11,44,52,10,19,125
9512,American,ORD,BOS,5,7,57,5,16,85
9513,Delta,DFW,DEN,14,38,14,9,22,83
9514,Delta,DFW,PHX,19,13,32,14,7,66
9515,Southwest,JFK,PHX,17,52,46,14,19,131
9516,JetBlue,JFK,DEN,11,55,44,0,7,106
9517,United,ORD,SEA,0,51,23,6,11,91
9518,Southwest,ATL,DEN,14,26,35,3,9,73
9519,JetBlue,DFW,MIA,13,30,54,4,14,102
9520,American,ORD,MIA,20,16,39,8,6,69
9521,American,DFW,MIA,11,14,1,8,7,30
9522,Delta,JFK,DEN,8,6,27,8,28,69
9523,United,LAX,BOS,12,37,10,1,19,67
9524,Delta,DFW,MIA,7,28,24,13,15,80
9525,American,ORD,DEN,5,32,28,13,18,91
9526,Delta,DFW,SEA,10,57,55,4,0,116
9527,Southwest,DFW,PHX,15,5,19,6,15,45
9528,American,LAX,MIA,23,21,6,6,1,34
9529,United,JFK,DEN,6,49,25,0,2,76
9530,Delta,DFW,BOS,9,44,46,0,10,100
9531,American,LAX,MIA,20,56,56,1,26,139
9532,JetBlue,ORD,PHX,7,39,24,9,12,84
9533,United,ATL,MIA,4,16,8,10,10,44
9534,United,JFK,SEA,17,34,24,0,26,84
9535,Southwest,ORD,PHX,10,45,35,6,8,94
9536,JetBlue,ORD,SEA,8,16,23,3,22,64
9537,JetBlue,ATL,DEN,6,14,54,0,27,95
9538,Southwest,LAX,MIA,11,38,7,7,17,69
9539,JetBlue,LAX,DEN,5,1,2,10,9,22
9540,United,ATL,PHX,23,43,39,6,9,97
9541,United,LAX,SEA,15,57,45,14,13,129
9542,JetBlue,LAX,DEN,21,35,2,0,19,56
9543,Delta,ATL,DEN,14,4,53,10,14,81
9544,United,ORD,SEA,11,25,40,13,10,88
9545,JetBlue,ORD,BOS,15,50,24,13,27,114
9546,Delta,DFW,DEN,23,41,45,0,28,114
9547,Southwest,ATL,SEA,12,23,45,10,11,89
9548,Delta,JFK,MIA,3,36,6,2,1,45
9549,Southwest,JFK,MIA,22,43,38,1,27,109
9550,United,LAX,SEA,21,13,16,11,0,40
9551,Southwest,DFW,MIA,21,17,55,7,14,93
9552,Delta,DFW,SEA,13,13,1,6,3,23
9553,Delta,ATL,PHX,10,53,46,2,28,129
9554,American,JFK,BOS,11,34,22,7,6,69
9555,Delta,DFW,MIA,7,52,15,14,29,110
9556,Southwest,LAX,BOS,20,32,42,7,24,105
9557,JetBlue,ATL,BOS,20,47,3,5,1,56
9558,Southwest,DFW,BOS,1,39,9,8,13,69
9559,JetBlue,JFK,SEA,21,26,50,11,26,113
9560,American,DFW,SEA,7,20,13,1,17,51
9561,Delta,LAX,BOS,21,48,36,2,10,96
9562,American,JFK,DEN,21,3,37,5,29,74
9563,American,ORD,BOS,17,40,24,5,2,71
9564,American,JFK,PHX,2,34,3,10,9,56
9565,United,ATL,MIA,12,12,0,1,2,15
9566,JetBlue,DFW,DEN,13,13,55,7,7,82
9567,American,LAX,BOS,3,32,25,9,10,76
9568,United,LAX,SEA,20,1,29,8,7,45
9569,Southwest,ATL,PHX,8,17,31,14,13,75
9570,United,ORD,PHX,13,11,10,11,16,48
9571,JetBlue,ATL,PHX,22,57,18,14,7,96
9572,American,ORD,PHX,22,59,46,13,18,136
9573,United,LAX,SEA,21,33,27,10,14,84
9574,Delta,LAX,DEN,16,26,13,11,14,64
9575,Delta,ORD,BOS,15,51,37,14,10,112
9576,Southwest,ATL,PHX,11,55,17,11,18,101
9577,Delta,ORD,DEN,4,30,10,8,7,55
9578,Southwest,DFW,SEA,15,49,35,7,2,93
9579,Delta,DFW,MIA,12,44,4,9,27,84
9580,JetBlue,LAX,MIA,14,12,37,5,29,83
9581,American,ATL,DEN,7,27,27,8,16,78
9582,Southwest,DFW,MIA,13,59,13,10,18,100
9583,United,ATL,MIA,18,26,31,11,18,86
9584,Southwest,ORD,PHX,19,14,59,12,13,98
9585,American,JFK,SEA,11,50,11,3,5,69
9586,Delta,DFW,BOS,0,27,10,14,10,61
9587,American,ATL,DEN,19,11,44,12,19,86
9588,JetBlue,LAX,SEA,8,52,48,1,7,108
9589,American,DFW,PHX,2,29,22,1,18,70
9590,American,JFK,PHX,19,33,33,13,23,102
9591,American,DFW,PHX,2,7,34,2,15,58
9592,American,ATL,DEN,19,12,30,9,20,71
9593,Delta,ORD,BOS,17,43,38,3,27,111
9594,JetBlue,ATL,DEN,12,12,47,1,29,89
9595,United,DFW,DEN,7,1,38,7,4,50
9596,Southwest,ORD,DEN,8,9,24,5,11,49
9597,Delta,LAX,PHX,11,34,30,2,24,90
9598,Southwest,ATL,BOS,3,32,47,4,19,102
9599,United,DFW,PHX,20,26,45,13,14,98
9600,Southwest,LAX,MIA,6,28,49,4,25,106
9601,Delta,JFK,PHX,19,52,49,11,2,114
9602,American,ORD,BOS,3,53,41,0,24,118
9603,Delta,ATL,MIA,8,2,2,0,21,25
9604,JetBlue,JFK,PHX,23,50,8,0,8,66
9605,United,LAX,SEA,11,47,46,13,19,125
9606,Southwest,DFW,BOS,21,56,47,6,23,132
9607,American,LAX,DEN,9,15,46,2,2,65
9608,Delta,LAX,MIA,15,6,10,9,2,27
9609,Delta,JFK,BOS,8,32,37,1,27,97
9610,American,LAX,BOS,23,52,5,1,4,62
9611,JetBlue,ORD,BOS,9,59,50,10,6,125
9612,Southwest,DFW,SEA,16,15,55,7,26,103
9613,Southwest,JFK,BOS,17,12,48,9,23,92
9614,Southwest,ORD,BOS,2,15,29,2,20,66
9615,Delta,ATL,BOS,15,21,43,7,10,81
9616,American,ORD,DEN,10,55,22,5,3,85
9617,American,LAX,SEA,8,38,51,10,18,117
9618,American,LAX,SEA,15,27,41,2,13,83
9619,Delta,DFW,MIA,14,33,59,8,28,128
9620,JetBlue,LAX,SEA,19,27,22,12,4,65
9621,Southwest,LAX,PHX,20,21,29,13,21,84
9622,United,ORD,SEA,5,18,27,1,11,57
9623,Delta,ORD,MIA,22,3,8,3,15,29
9624,American,DFW,MIA,5,55,39,2,24,120
9625,JetBlue,LAX,PHX,17,31,55,14,5,105
9626,JetBlue,JFK,DEN,19,43,59,4,10,116
9627,JetBlue,ORD,MIA,7,49,17,6,8,80
9628,American,ATL,MIA,0,43,52,4,13,112
9629,Delta,DFW,DEN,5,49,59,14,16,138
9630,JetBlue,DFW,SEA,13,4,54,1,0,59
9631,JetBlue,LAX,PHX,11,19,12,6,25,62
9632,American,JFK,PHX,8,55,17,3,22,97
9633,JetBlue,JFK,BOS,20,58,48,13,20,139
9634,Delta,ORD,BOS,2,23,13,4,12,52
9635,American,DFW,DEN,10,3,35,8,22,68
9636,Southwest,ORD,PHX,7,31,2,9,4,46
9637,American,ORD,PHX,17,51,29,13,26,119
9638,JetBlue,ORD,SEA,19,56,11,5,25,97
9639,Southwest,DFW,SEA,22,0,59,13,11,83
9640,JetBlue,LAX,MIA,18,32,14,8,28,82
9641,Delta,LAX,DEN,22,54,47,5,25,131
9642,American,ORD,SEA,8,7,20,13,23,63
9643,American,JFK,MIA,20,50,34,3,0,87
9644,American,LAX,DEN,5,52,38,3,3,96
9645,United,JFK,PHX,5,46,42,0,17,105
9646,American,LAX,DEN,1,33,45,11,5,94
9647,United,DFW,PHX,22,24,6,6,3,39
9648,Southwest,LAX,BOS,14,49,6,13,9,77
9649,Southwest,JFK,PHX,23,3,34,3,8,48
9650,American,ATL,SEA,15,4,26,9,5,44
9651,Delta,LAX,PHX,14,7,17,9,9,42
9652,United,ORD,BOS,12,51,58,6,15,130
9653,JetBlue,ORD,BOS,5,17,3,5,14,39
9654,JetBlue,JFK,PHX,22,31,24,8,10,73
9655,Southwest,JFK,MIA,8,19,50,14,23,106
9656,JetBlue,DFW,PHX,16,23,1,8,25,57
9657,American,ATL,BOS,16,7,38,2,20,67
9658,Southwest,LAX,SEA,0,15,43,11,12,81
9659,United,JFK,BOS,12,57,37,8,15,117
9660,JetBlue,ORD,BOS,22,49,10,7,20,86
9661,American,DFW,PHX,23,14,14,12,4,44
9662,JetBlue,ATL,BOS,7,16,32,6,26,80
9663,American,LAX,MIA,4,32,54,8,13,107
9664,Delta,ATL,SEA,16,43,5,8,12,68
9665,United,ORD,MIA,17,18,26,9,7,60
9666,Southwest,DFW,BOS,17,0,51,11,27,89
9667,American,ATL,BOS,0,37,30,13,20,100
9668,JetBlue,LAX,PHX,12,48,45,11,8,112
9669,United,DFW,MIA,20,6,47,10,9,72
9670,American,ATL,SEA,3,13,51,11,17,92
9671,Southwest,ORD,SEA,16,35,33,10,2,80
9672,JetBlue,LAX,PHX,3,47,5,5,19,76
9673,JetBlue,ORD,DEN,22,19,2,4,13,38
9674,American,ORD,PHX,12,13,6,13,5,37
9675,United,JFK,SEA,22,0,31,13,19,63
9676,Southwest,DFW,DEN,6,40,43,2,28,113
9677,United,LAX,SEA,20,54,34,8,15,111
9678,Southwest,LAX,SEA,21,52,44,13,14,123
9679,Southwest,JFK,PHX,17,54,47,14,21,136
9680,United,ATL,BOS,10,32,23,14,23,92
9681,Southwest,ATL,MIA,17,10,13,2,28,53
9682,American,LAX,DEN,4,6,58,10,23,97
9683,JetBlue,ORD,DEN,0,19,19,14,8,60
9684,American,ATL,SEA,8,21,15,10,10,56
9685,Delta,DFW,MIA,23,44,29,14,14,101
9686,American,JFK,PHX,14,33,28,6,0,67
9687,Delta,DFW,DEN,4,37,3,7,5,52
9688,Southwest,ATL,BOS,0,26,13,8,7,54
9689,United,JFK,BOS,14,51,39,6,24,120
9690,JetBlue,ATL,PHX,16,20,40,2,21,83
9691,JetBlue,DFW,SEA,12,23,50,4,20,97
9692,Delta,ATL,MIA,10,11,47,6,1,65
9693,Southwest,ORD,MIA,13,43,12,1,12,68
9694,JetBlue,ATL,SEA,14,56,15,11,18,100
9695,Southwest,LAX,SEA,3,27,2,14,9,52
9696,JetBlue,LAX,MIA,1,58,3,10,10,81
9697,Delta,LAX,SEA,8,54,53,3,17,127
9698,American,JFK,DEN,13,26,20,13,10,69
9699,JetBlue,ATL,DEN,16,27,50,6,20,103
9700,JetBlue,LAX,DEN,13,43,32,7,12,94
9701,United,DFW,MIA,21,59,43,11,12,125
9702,American,LAX,DEN,5,30,21,13,9,73
9703,Southwest,ORD,MIA,5,9,16,3,17,45
9704,American,JFK,PHX,15,57,59,13,9,138
9705,Delta,LAX,BOS,17,48,35,0,23,106
9706,Southwest,ATL,PHX,4,3,44,4,18,69
9707,JetBlue,LAX,BOS,2,28,39,5,18,90
9708,Delta,LAX,MIA,0,36,1,13,29,79
9709,Delta,DFW,BOS,20,25,31,12,5,73
9710,Delta,ORD,BOS,13,53,28,10,9,100
9711,Delta,DFW,BOS,21,58,49,4,15,126
9712,Southwest,ORD,MIA,0,15,58,0,5,78
9713,Southwest,JFK,MIA,23,56,51,11,8,126
9714,Delta,DFW,BOS,23,33,49,7,18,107
9715,United,LAX,DEN,1,38,19,6,2,65
9716,Southwest,ORD,BOS,22,11,46,6,3,66
9717,American,LAX,MIA,1,46,52,10,27,135
9718,Delta,DFW,DEN,14,32,31,12,26,101
9719,JetBlue,ATL,BOS,2,13,11,7,21,52
9720,Delta,LAX,BOS,9,54,15,1,25,95
9721,JetBlue,ORD,DEN,16,12,40,10,23,85
9722,Southwest,ATL,PHX,2,58,4,7,10,79
9723,JetBlue,LAX,MIA,11,54,5,14,21,94
9724,Delta,ATL,SEA,17,26,1,6,0,33
9725,American,LAX,SEA,6,55,7,14,16,92
9726,United,JFK,BOS,15,2,47,13,11,73
9727,American,ATL,MIA,0,23,0,0,26,49
9728,American,LAX,MIA,0,42,16,11,22,91
9729,United,JFK,PHX,4,12,31,1,26,70
9730,American,ATL,MIA,10,53,39,2,22,116
9731,United,JFK,PHX,5,39,44,5,0,88
9732,American,DFW,SEA,22,57,7,14,11,89
9733,Southwest,JFK,MIA,17,17,30,2,23,72
9734,Southwest,ATL,DEN,22,51,46,7,13,117
9735,Delta,DFW,SEA,22,1,8,0,12,21
9736,JetBlue,DFW,DEN,21,30,22,3,7,62
9737,American,LAX,MIA,22,34,43,5,16,98
9738,United,DFW,PHX,11,41,42,1,4,88
9739,United,LAX,MIA,3,26,34,0,5,65
9740,American,DFW,BOS,1,57,24,9,12,102
9741,United,JFK,SEA,13,31,47,9,20,107
9742,JetBlue,LAX,SEA,13,40,40,12,26,118
9743,United,JFK,PHX,14,39,56,12,3,110
9744,United,ORD,MIA,0,52,7,5,14,78
9745,American,JFK,MIA,4,38,47,12,28,125
9746,United,DFW,DEN,9,16,24,6,6,52
9747,JetBlue,JFK,BOS,16,50,58,1,28,137
9748,Delta,LAX,BOS,6,25,8,5,7,45
9749,Delta,LAX,PHX,4,46,27,6,27,106
9750,American,ATL,DEN,15,14,52,11,22,99
9751,Delta,ORD,MIA,11,36,46,3,19,104
9752,JetBlue,LAX,PHX,13,24,55,14,13,106
9753,United,ORD,DEN,1,21,57,12,14,104
9754,Southwest,ORD,MIA,0,48,17,1,5,71
9755,United,LAX,BOS,12,21,35,11,12,79
9756,JetBlue,DFW,DEN,7,12,29,10,29,80
9757,JetBlue,ORD,SEA,20,44,52,8,4,108
9758,United,ORD,SEA,11,54,34,1,3,92
9759,Delta,ORD,MIA,9,18,39,2,7,66
9760,JetBlue,DFW,SEA,20,4,20,5,13,42
9761,United,ORD,DEN,23,56,50,7,9,122
9762,JetBlue,LAX,DEN,10,13,27,3,13,56
9763,Delta,JFK,MIA,21,44,37,13,22,116
9764,Southwest,DFW,MIA,4,47,28,2,21,98
9765,JetBlue,LAX,DEN,23,30,50,2,9,91
9766,American,LAX,MIA,4,15,14,14,19,62
9767,Southwest,ORD,MIA,19,22,49,6,22,99
9768,JetBlue,ATL,MIA,15,13,23,11,15,62
9769,Southwest,ATL,SEA,18,15,39,6,0,60
9770,JetBlue,ATL,SEA,23,10,30,13,21,74
9771,JetBlue,ORD,MIA,22,43,46,10,10,109
9772,United,JFK,DEN,21,27,16,0,19,62
9773,JetBlue,ORD,PHX,20,59,55,1,2,117
9774,Southwest,LAX,BOS,17,28,36,5,5,74
9775,United,LAX,DEN,22,42,17,4,25,88
9776,JetBlue,ATL,DEN,6,36,14,13,11,74
9777,Southwest,ATL,DEN,0,47,55,7,10,119
9778,United,ATL,DEN,4,43,21,4,25,93
9779,American,LAX,MIA,17,32,2,0,6,40
9780,Delta,ATL,PHX,19,36,53,2,1,92
9781,Southwest,JFK,DEN,3,7,7,2,25,41
9782,American,JFK,MIA,0,26,58,11,3,98
9783,JetBlue,ORD,BOS,14,28,1,4,24,57
9784,American,ORD,DEN,22,4,34,9,18,65
9785,Southwest,DFW,MIA,23,18,38,5,20,81
9786,Southwest,DFW,MIA,6,22,41,2,26,91
9787,Delta,ATL,BOS,11,57,44,5,22,128
9788,JetBlue,DFW,PHX,1,20,42,1,6,69
9789,Southwest,ORD,PHX,20,30,5,5,5,45
9790,American,LAX,BOS,16,18,36,3,4,61
9791,Delta,JFK,BOS,12,8,39,8,24,79
9792,Delta,JFK,MIA,17,20,31,1,8,60
9793,JetBlue,ATL,PHX,5,13,3,7,1,24
9794,Delta,LAX,MIA,18,17,17,10,18,62
9795,Southwest,ORD,MIA,5,24,19,4,2,49
9796,American,ORD,SEA,1,50,2,7,11,70
9797,Delta,ORD,DEN,23,1,6,9,14,30
9798,Delta,ORD,SEA,16,33,53,13,18,117
9799,United,DFW,DEN,18,6,49,11,1,67
9800,Delta,ORD,SEA,7,22,4,0,10,36
9801,American,DFW,PHX,23,42,34,10,22,108
9802,American,JFK,PHX,11,44,39,6,24,113
9803,American,JFK,SEA,21,3,24,7,17,51
9804,Southwest,LAX,BOS,4,33,55,3,27,118
9805,JetBlue,ORD,BOS,6,32,25,1,12,70
9806,Delta,LAX,PHX,23,17,13,4,10,44
9807,Southwest,DFW,MIA,7,38,38,10,28,114
9808,Delta,LAX,BOS,3,46,20,3,21,90
9809,Delta,LAX,BOS,23,26,42,9,21,98
9810,Delta,ATL,BOS,22,29,50,11,5,95
9811,Southwest,ATL,DEN,11,11,14,5,11,41
9812,Delta,ATL,MIA,21,3,5,4,2,14
9813,Southwest,LAX,DEN,23,26,45,5,20,96
9814,American,ATL,DEN,3,59,51,13,22,145
9815,United,LAX,PHX,21,42,52,11,12,117
9816,Delta,ATL,SEA,3,8,29,2,7,46
9817,Delta,ORD,SEA,13,32,9,1,12,54
9818,United,LAX,MIA,20,26,40,6,24,96
9819,United,DFW,SEA,14,6,26,2,18,52
9820,Southwest,ORD,MIA,9,7,33,10,21,71
9821,Delta,ATL,BOS,19,57,9,11,10,87
9822,Delta,JFK,DEN,4,39,20,6,27,92
9823,American,LAX,DEN,14,41,2,5,25,73
9824,American,LAX,SEA,23,59,21,0,12,92
9825,Southwest,ORD,PHX,19,19,29,7,20,75
9826,Delta,JFK,PHX,4,42,57,8,9,116
9827,JetBlue,LAX,DEN,20,51,27,13,7,98
9828,Delta,ATL,BOS,2,9,6,11,12,38
9829,Southwest,ORD,DEN,0,30,52,7,20,109
9830,Delta,ORD,DEN,11,57,36,1,18,112
9831,JetBlue,DFW,PHX,10,35,11,4,9,59
9832,United,ORD,BOS,15,36,46,8,19,109
9833,United,LAX,BOS,10,13,53,2,26,94
9834,American,DFW,BOS,14,10,52,12,2,76
9835,Southwest,JFK,MIA,18,28,33,14,28,103
9836,JetBlue,DFW,SEA,2,19,59,11,19,108
9837,American,DFW,DEN,0,53,44,0,21,118
9838,United,ATL,PHX,18,42,20,4,8,74
9839,Delta,DFW,SEA,7,40,23,6,1,70
9840,Delta,LAX,BOS,19,58,40,11,5,114
9841,United,ORD,PHX,21,23,45,0,13,81
9842,Delta,ORD,BOS,16,20,57,0,6,83
9843,Southwest,ATL,DEN,10,35,3,7,3,48
9844,American,ORD,PHX,3,37,29,6,25,97
9845,United,ORD,SEA,3,34,31,11,12,88
9846,Southwest,ORD,SEA,20,51,40,11,2,104
9847,American,ORD,BOS,2,0,3,9,0,12
9848,American,DFW,SEA,13,27,58,8,16,109
9849,United,JFK,MIA,21,1,28,3,4,36
9850,American,LAX,PHX,8,28,56,12,16,112
9851,JetBlue,ORD,DEN,10,18,36,8,1,63
9852,Delta,ORD,MIA,5,22,42,8,12,84
9853,American,JFK,SEA,16,33,9,6,18,66
9854,Delta,ORD,MIA,14,21,6,9,9,45
9855,United,JFK,MIA,2,48,1,9,24,82
9856,United,ATL,BOS,23,1,37,7,10,55
9857,American,ORD,SEA,20,40,12,7,13,72
9858,American,ATL,PHX,1,45,11,4,4,64
9859,Southwest,JFK,SEA,18,19,6,11,27,63
9860,Delta,ATL,DEN,9,4,54,11,29,98
9861,American,ORD,BOS,5,45,36,3,2,86
9862,United,DFW,MIA,17,36,58,2,26,122
9863,United,ORD,PHX,11,37,18,8,26,89
9864,JetBlue,LAX,DEN,21,16,1,12,16,45
9865,United,LAX,DEN,11,25,42,14,16,97
9866,American,ORD,BOS,18,59,12,9,1,81
9867,Southwest,DFW,BOS,23,27,13,4,23,67
9868,JetBlue,DFW,DEN,2,10,52,1,27,90
9869,American,LAX,SEA,9,34,50,12,19,115
9870,United,ORD,PHX,23,3,45,10,20,78
9871,American,ATL,MIA,21,50,56,11,13,130
9872,United,DFW,BOS,6,29,59,1,15,104
9873,American,ORD,PHX,8,57,21,0,7,85
9874,Southwest,JFK,MIA,0,29,40,5,23,97
9875,American,JFK,PHX,5,40,48,5,18,111
9876,JetBlue,DFW,MIA,3,49,58,3,23,133
9877,Delta,LAX,SEA,5,55,14,14,9,92
9878,Southwest,ATL,BOS,14,47,41,13,17,118
9879,Delta,JFK,MIA,15,52,23,4,3,82
9880,JetBlue,ATL,SEA,11,6,28,4,20,58
9881,American,LAX,SEA,9,11,54,14,12,91
9882,American,DFW,MIA,22,3,49,3,28,83
9883,United,DFW,PHX,21,35,20,0,19,74
9884,Southwest,LAX,PHX,16,50,32,14,6,102
9885,Delta,DFW,DEN,19,2,6,12,13,33
9886,JetBlue,ATL,PHX,11,35,33,8,26,102
9887,Southwest,JFK,DEN,2,29,13,3,8,53
9888,United,ATL,DEN,1,36,50,14,27,127
9889,American,DFW,MIA,10,47,49,11,24,131
9890,JetBlue,DFW,MIA,14,36,48,9,23,116
9891,JetBlue,ORD,MIA,12,35,42,9,28,114
9892,JetBlue,ATL,MIA,23,7,56,9,12,84
9893,Southwest,ORD,SEA,15,32,7,12,17,68
9894,Delta,ATL,SEA,7,58,17,1,22,98
9895,Delta,ATL,DEN,14,31,29,6,27,93
9896,Southwest,JFK,BOS,22,55,12,8,0,75
9897,JetBlue,LAX,DEN,22,1,43,0,14,58
9898,Southwest,DFW,MIA,21,51,21,14,10,96
9899,JetBlue,LAX,DEN,16,12,33,8,20,73
9900,JetBlue,LAX,BOS,13,41,40,8,25,114
9901,United,JFK,PHX,6,39,19,1,13,72
9902,JetBlue,ORD,MIA,2,35,31,7,8,81
9903,Delta,LAX,PHX,18,6,2,14,6,28
9904,Southwest,ATL,PHX,1,44,18,1,19,82
9905,American,ATL,BOS,23,53,54,4,18,129
9906,Southwest,ATL,SEA,8,33,59,9,6,107
9907,JetBlue,ATL,SEA,4,9,22,1,11,43
9908,American,ATL,DEN,17,41,17,9,20,87
9909,Delta,DFW,BOS,16,23,49,7,23,102
9910,JetBlue,LAX,BOS,7,10,43,6,4,63
9911,United,LAX,MIA,21,58,31,5,6,100
9912,United,ATL,PHX,15,59,41,13,6,119
9913,American,DFW,DEN,1,38,20,1,9,68
9914,JetBlue,DFW,SEA,15,17,7,5,22,51
9915,American,ORD,DEN,18,5,17,7,4,33
9916,Delta,ORD,PHX,16,35,8,1,25,69
9917,Southwest,DFW,DEN,3,47,39,10,22,118
9918,JetBlue,ATL,DEN,10,3,35,4,10,52
9919,Delta,JFK,DEN,16,54,41,1,18,114
9920,United,JFK,PHX,5,16,5,2,9,32
9921,JetBlue,JFK,SEA,1,56,3,8,16,83
9922,JetBlue,ATL,DEN,5,20,50,6,25,101
9923,United,DFW,BOS,18,46,40,8,11,105
9924,Delta,JFK,BOS,23,45,29,2,9,85
9925,American,LAX,BOS,1,28,4,13,26,71
9926,American,DFW,BOS,23,49,51,13,11,124
9927,United,DFW,PHX,10,54,1,11,25,91
9928,Delta,ORD,BOS,16,52,24,6,20,102
9929,United,ORD,PHX,4,9,57,7,21,94
9930,Delta,ATL,SEA,11,12,9,8,0,29
9931,Southwest,LAX,MIA,2,42,19,8,21,90
9932,Southwest,LAX,DEN,7,11,34,3,11,59
9933,JetBlue,LAX,BOS,10,27,4,10,5,46
9934,JetBlue,LAX,BOS,8,45,3,0,4,52
9935,American,JFK,SEA,13,27,4,11,24,66
9936,Southwest,DFW,PHX,23,56,33,2,20,111
9937,JetBlue,LAX,MIA,4,6,11,1,15,33
9938,Southwest,JFK,MIA,20,21,21,5,25,72
9939,JetBlue,DFW,PHX,14,44,52,6,21,123
9940,JetBlue,DFW,DEN,15,35,52,1,21,109
9941,American,JFK,BOS,11,13,29,13,10,65
9942,Southwest,LAX,MIA,7,39,7,1,29,76
9943,Southwest,JFK,DEN,23,50,43,1,2,96
9944,United,ORD,DEN,13,18,38,11,6,73
9945,Delta,JFK,SEA,9,43,22,5,22,92
9946,United,ORD,PHX,15,42,11,5,5,63
9947,JetBlue,JFK,PHX,17,58,20,7,1,86
9948,JetBlue,LAX,MIA,19,40,48,13,29,130
9949,Delta,ATL,DEN,12,11,23,1,29,64
9950,American,JFK,SEA,18,28,26,8,9,71
9951,United,DFW,PHX,14,0,9,0,13,22
9952,Southwest,DFW,MIA,6,56,1,4,22,83
9953,JetBlue,DFW,MIA,11,32,38,0,22,92
9954,JetBlue,JFK,BOS,6,35,7,5,4,51
9955,United,ATL,MIA,12,32,2,13,13,60
9956,Delta,JFK,BOS,9,2,39,12,15,68
9957,Southwest,DFW,BOS,11,2,23,2,24,51
9958,United,ATL,MIA,20,2,8,3,11,24
9959,United,ORD,PHX,3,3,35,5,13,56
9960,Southwest,ATL,DEN,2,9,11,4,21,45
9961,Southwest,DFW,DEN,2,57,56,0,26,139
9962,American,ORD,MIA,10,53,58,9,2,122
9963,Delta,ATL,PHX,1,3,43,4,26,76
9964,American,DFW,MIA,17,55,10,5,26,96
9965,Southwest,ATL,PHX,18,0,0,0,11,11
9966,Delta,JFK,SEA,1,33,42,3,24,102
9967,American,LAX,MIA,18,26,4,9,22,61
9968,United,LAX,DEN,12,55,46,7,4,112
9969,Southwest,ORD,SEA,3,30,4,13,8,55
9970,American,JFK,DEN,13,18,31,8,6,63
9971,United,ORD,DEN,11,49,57,9,9,124
9972,Southwest,ORD,BOS,21,12,20,8,8,48
9973,American,LAX,PHX,16,6,19,1,13,39
9974,Southwest,LAX,PHX,21,59,54,13,21,147
9975,Southwest,ATL,MIA,12,57,21,2,26,106
9976,American,JFK,MIA,5,30,3,14,1,48
9977,American,ORD,MIA,3,12,6,12,15,45
9978,JetBlue,ORD,BOS,10,41,29,5,8,83
9979,American,JFK,SEA,16,26,26,5,16,73
9980,JetBlue,ATL,PHX,16,40,37,8,16,101
9981,Southwest,ORD,PHX,1,39,31,11,17,98
9982,American,LAX,SEA,16,48,45,2,12,107
9983,American,ORD,MIA,1,25,27,2,9,63
9984,United,ORD,SEA,14,48,25,6,18,97
9985,JetBlue,ATL,DEN,23,19,17,10,13,59
9986,Southwest,LAX,BOS,17,51,49,12,22,134
9987,Southwest,ATL,PHX,19,22,11,2,29,64
9988,Delta,ORD,MIA,16,33,41,6,24,104
9989,Southwest,JFK,BOS,1,22,54,4,1,81
9990,American,ORD,BOS,20,4,47,5,28,84
9991,United,LAX,BOS,18,24,37,7,21,89
9992,JetBlue,ATL,SEA,0,16,22,4,14,56
9993,United,JFK,BOS,20,27,56,0,23,106
9994,United,LAX,DEN,6,13,5,5,6,29
9995,Delta,JFK,DEN,19,5,30,8,3,46
9996,American,DFW,PHX,3,25,26,13,18,82
9997,JetBlue,DFW,DEN,20,39,43,11,10,103
9998,United,LAX,SEA,13,30,12,12,20,74
9999,United,LAX,PHX,10,30,24,0,19,73
10000,United,DFW,DEN,5,11,15,2,28,56
